"director_facebook_likes","cast_total_facebook_likes","num_voted_users","num_user_for_reviews","imdb_score","movie_facebook_likes","Revenue","Budget","profit","response"
147,64798,272670,1022,8.2,72000,1152721930,250000000,902721930,1
144,49684,148379,622,7.3,54000,543368024,178000000,365368024,1
123,5505,111609,781,7.3,89000,433537548,160000000,273537548,1
91,4807,27198,131,4.6,8000,50163103,4000000,46163103,1
136,36188,496749,742,7.8,55000,714766572,170000000,544766572,1
123,11287,118992,971,6.9,80000,490998335,175000000,315998335,1
129,23031,40862,139,6.9,15000,331411972,90000000,241411972,1
183,24450,371639,3018,6.9,197000,872662631,250000000,622662631,1
107,14569,33354,110,6.6,10000,113768303,50000000,63768303,1
120,40025,552503,1588,8.1,191000,378436354,150000000,228436354,1
124,8458,418214,1290,7,150000,1513528810,150000000,1363528810,1
169,31488,928227,2725,8.6,349000,621752480,165000000,456752480,1
108,18239,479047,1058,8.1,117000,778617348,58000000,720617348,1
140,79150,278232,657,7.2,94000,1506249360,190000000,1316249360,1
124,19761,508818,679,6.9,46000,370569774,140000000,230569774,1
123,81385,305008,591,6.7,52000,752100229,125000000,627100229,1
87,4782,24407,155,6.8,36000,342472030,75000000,267472030,1
97,24350,27130,126,6.3,14000,346450645,73000000,273450645,1
91,13616,142403,275,6.4,70000,1156730962,74000000,1082730962,1
120,46719,37750,134,6.1,16000,164602163,115000000,49602163,1
151,14831,472488,1023,8.1,153000,595380321,108000000,487380321,1
149,4348,569841,1127,8.1,146000,369330363,61000000,308330363,1
114,20295,467613,608,8.1,165000,233555708,14000000,219555708,1
121,32438,682155,1097,8.1,96000,773312399,170000000,603312399,1
113,1783,310903,524,6.8,38000,348319861,34000000,314319861,1
134,2676,64989,279,7.8,40000,315816419,40000000,275816419,1
106,35367,89770,342,5.6,39000,243637091,88000000,155637091,1
114,16718,147497,499,6.1,52000,470490832,110000000,360490832,1
123,13752,40123,297,7.1,31000,254351812,120000000,134351812,1
125,13312,447979,629,7.3,105000,117698894,75000000,42698894,1
156,57108,406020,1188,8.1,190000,532925985,135000000,397925985,1
164,9152,354228,802,7.5,65000,955119788,250000000,705119788,1
137,81385,166137,383,6.6,38000,639827109,160000000,479827109,1
148,11700,275868,994,6.8,85000,880674609,245000000,635674609,1
130,5046,128306,497,6.5,37000,209035668,190000000,19035668,1
102,2963,279093,433,7.9,41000,652105443,165000000,487105443,1
124,16881,147128,277,7.5,44000,91709827,30000000,61709827,1
117,5730,313866,549,7.4,61000,518178306,130000000,388178306,1
148,81115,1468200,2803,8.8,175000,825500000,160000000,665500000,1
152,57802,1676169,4667,9,37000,1001921825,185000000,816921825,1
141,92000,462669,1117,7.5,118000,1405035767,250000000,1155035767,1
120,23051,172965,627,6.9,67000,102069268,49000000,53069268,1
128,59558,980946,2685,8.3,15000,374218673,150000000,224218673,1
149,91434,514125,752,8,82000,7.46e+08,250000000,4.96e+08,1
146,49355,498397,706,7.6,82000,847423452,130000000,717423452,1
132,37605,229574,436,7.2,56000,192330738,55000000,137330738,1
125,30010,117739,229,6.4,30000,215863606,68000000,147863606,1
89,32325,327367,918,6.4,83000,463360063,40000000,423360063,1
95,2944,345198,773,8.3,118000,857427711,175000000,682427711,1
171,22342,1238746,5060,8.8,21000,871368364,93000000,778368364,1
98,10894,19611,103,6.7,0,41008532,27000000,14008532,1
187,49912,272839,1018,7.9,114000,155760117,44000000,111760117,1
114,16992,76010,205,6.6,15000,71561644,50000000,21561644,1
107,26495,399138,731,8.5,129000,13993092,3300000,10693092,1
95,36095,64322,145,7.2,24000,519881355,145000000,374881355,1
164,106759,1144337,2701,8.5,164000,1081041287,250000000,831041287,1
96,2635,665575,704,8.3,27000,731342744,175000000,556342744,1
178,4834,886204,3054,7.9,33000,2781505847,237000000,2544505847,1
133,10565,249688,548,7.8,93000,305151265,12000000,293151265,1
118,2499,161288,351,8.3,72000,35401758,6000000,29401758,1
129,4585,220020,1360,4.1,101000,569651467,40000000,529651467,1
139,22226,341058,713,6.7,49000,288747895,85000000,203747895,1
114,15428,87950,207,6.5,15000,53181600,28000000,25181600,1
109,24063,49671,166,6,11000,94073028,11500000,82573028,1
112,9049,300110,807,7.5,131000,318000141,13000000,305000141,1
240,46057,780588,1138,8.2,138000,392000694,100000000,292000694,1
165,3988,242420,918,5.7,56000,245500000,210000000,35500000,1
112,59803,414070,532,7.1,63000,479765000,170000000,309765000,1
136,18563,1217752,3646,8.7,25000,463517383,63000000,400517383,1
143,48184,809474,2113,8.1,10000,655011224,140000000,515011224,1
172,23052,1100446,2417,8.7,10000,926287400,79000000,847287400,1
103,6807,92364,244,6.5,15000,108782847,9000000,99782847,1
115,13159,97697,185,6.5,40000,286633264,29000000,257633264,1
121,1467,196217,461,7.6,59000,84025816,30000000,54025816,1
126,19769,51892,273,5.5,24000,143055748,140000000,3055748,1
110,4882,39440,83,6.1,15000,1.12e+08,38000000,7.4e+07,1
117,15554,293304,552,7.9,65000,38697217,8500000,30197217,1
133,16277,325264,916,7.3,112000,542307423,58800000,483507423,1
142,15700,1251222,1398,8.8,59000,677945399,55000000,622945399,1
99,20276,69484,323,5.9,28000,195725584,60000000,135725584,1
89,5056,31915,159,4.4,18000,102529779,5000000,97529779,1
73,6458,644348,656,8.5,17000,788241776,45000000,743241776,1
98,53587,67223,126,6.2,11000,349424282,127000000,222424282,1
141,30183,136973,275,7.4,47000,83719388,50000000,33719388,1
192,6434,1215718,3189,8.9,16000,1118888979,94000000,1024888979,1
153,2829,744891,983,8.5,13000,5.2e+08,100000000,4.2e+08,1
116,15735,175960,360,7.3,43000,108145109,75000000,33145109,1
128,23996,477300,621,7.6,20000,524028679,90000000,434028679,1
127,47334,139593,720,5.4,44000,183987723,176000003,7987720,1
94,1488,84382,158,5.1,0,126069509,40000000,86069509,1
178,16557,1324680,2195,8.9,45000,213928762,8000000,205928762,1
116,3230,732212,809,8.5,39000,381109762,19000000,362109762,1
118,27468,286095,974,6.6,0,371353001,200000000,171353001,1
102,2582,421658,904,7.6,58000,1274219009,150000000,1124219009,1
136,54083,370704,484,6.7,58000,1021683000,250000000,771683000,1
108,430,289508,611,7.7,109000,36869414,15000000,21869414,1
93,696,62836,345,6.8,20000,331926147,175000000,156926147,1
144,9125,470483,2301,8,0,599045960,150000000,449045960,1
112,19974,55617,266,5.2,14000,109902567,38000000,71902567,1
133,15106,146708,362,7.7,70000,137935567,35000000,102935567,1
169,48350,471220,1238,7.1,0,9.61e+08,300000000,6.61e+08,1
104,14504,126893,440,7.3,33000,108286421,15000000,93286421,1
109,19968,408302,345,7.2,39000,201585328,42000000,159585328,1
92,19963,60230,118,6.7,11000,373552094,132000000,241552094,1
115,60059,536314,738,7,63000,444115007,150000000,294115007,1
195,30426,557489,1187,7.2,95000,1215439994,200000000,1015439994,1
113,12652,431620,741,7.9,77000,370541256,178000000,192541256,1
154,16785,430055,856,6.9,16000,816969268,75000000,741969268,1
126,39252,696338,1055,7.9,10000,585174222,140000000,445174222,1
130,14363,317542,620,7.6,45000,708200000,170000000,538200000,1
117,17847,57674,126,6.5,11000,30523226,26000000,4523226,1
106,38494,60926,302,6.4,23000,63229796,22000000,41229796,1
153,36741,885175,1527,8.3,42000,319131050,70000000,249131050,1
91,87,582917,1885,7.8,147000,716392705,105000000,611392705,1
142,28631,321227,1067,6.7,41000,705717432,200000000,505717432,1
142,13495,1689764,4144,9.3,108000,28341469,25000000,3341469,1
100,5641,692482,866,8.2,11000,864625978,94000000,770625978,1
116,30571,114294,187,6.3,12000,106645357,42000000,64645357,1
97,15516,252257,634,7,89000,758410378,180000000,578410378,1
87,11608,385943,296,7.7,31000,543513985,69000000,474513985,1
143,2039,522030,1498,7.8,80000,1108561013,200000000,908561013,1
142,16944,178118,355,7.6,55000,165478348,40000000,125478348,1
111,4764,473887,626,8,10000,623722818,150000000,473722818,1
98,12998,403014,289,7.3,0,589390539,90000000,499390539,1
106,2023,330784,1243,6.7,0,586090727,200000000,386090727,1
97,2771,216581,397,6.4,21000,268157400,18000000,250157400,1
98,11905,286877,284,7.5,56000,970761885,76000000,894761885,1
115,12906,661017,771,8.5,16000,389925971,18000000,371925971,1
121,40484,544665,2012,7.3,5000,821708551,139000000,682708551,1
130,57308,182983,374,7.8,99000,133346506,28000000,105346506,1
133,21768,365104,512,7.4,35000,694713380,145000000,549713380,1
151,48486,522040,1832,7.3,5000,1065659812,200000000,865659812,1
112,1322,467234,1083,8.2,27000,83258226,19000000,64258226,1
143,20495,548573,2536,7.2,118000,662845518,225000000,437845518,1
107,4223,290949,629,7.8,13000,98235548,18000000,80235548,1
126,2725,269033,817,7.6,12000,411348924,35000000,376348924,1
103,5437,328159,467,7.6,3000,383257136,59000000,324257136,1
116,2524,563827,1110,8.5,23000,104931801,11000000,93931801,1
107,3582,600266,692,8.1,13000,78371200,6400000,71971200,1
150,26490,128682,657,6.1,51000,268031828,140000000,128031828,1
118,11898,329969,524,7.6,0,3.33e+08,28000000,3.05e+08,1
134,4251,439176,695,8.1,83000,1.87e+08,20000000,1.67e+08,1
119,13249,407601,849,7.9,0,214034224,60000000,154034224,1
131,19166,381148,1106,7,83000,407602906,180000000,227602906,1
112,9131,117927,501,5.2,0,401128639,145000000,256128639,1
105,54039,130272,209,5.9,2000,413106170,150000000,263106170,1
175,28122,1155770,2238,9.2,43000,245066411,6000000,239066411,1
131,40585,592582,722,8.2,25000,140767956,28000000,112767956,1
171,6521,982637,2368,8.5,21000,457640427,103000000,354640427,1
103,3698,667983,877,8.1,18000,264118201,60000000,204118201,1
131,21840,232187,440,7.4,47000,682330139,150000000,532330139,1
92,12754,307029,360,7.6,6000,631744560,130000000,501744560,1
151,13209,1347461,2968,8.8,48000,100853753,63000000,37853753,1
115,12068,387632,789,7.1,0,347234916,120000000,227234916,1
86,1777,266636,385,6.9,0,532680671,75000000,457680671,1
101,15500,437418,609,8.1,38000,70906973,14600000,56306973,1
104,3627,106820,147,6.5,14000,136621271,17000000,119621271,1
99,15082,475518,644,8.1,149000,174600318,30000000,144600318,1
132,21411,395573,1171,7.8,92000,467365246,190000000,277365246,1
215,2530,392474,1229,7.7,18000,185258983,130000000,55258983,1
112,2639,531737,1262,8,22000,210819611,30000000,180819611,1
102,10583,225273,523,6.2,71000,337580051,110000000,227580051,1
156,46055,383056,1902,6.2,0,890871626,258000000,632871626,1
182,9152,637246,1367,7.9,166000,1017003568,250000000,767003568,1
124,75793,75329,256,6.6,24000,101134059,60000000,41134059,1
124,48638,522371,723,7,18000,623933331,200000000,423933331,1
100,1261,110486,695,4.3,41000,167977596,120000001,47977595,1
133,1777,208092,806,7,0,95708457,22000000,73708457,1
115,57844,320284,1361,6.7,0,474968763,150000000,324968763,1
115,1901,479166,815,8,0,631442092,92000000,539442092,1
165,40978,955174,1193,8.5,199000,425368238,100000000,325368238,1
115,17369,491077,820,8.1,0,442824138,70000000,372824138,1
138,29585,786092,964,8.1,53000,294804195,80000000,214804195,1
108,14161,348232,806,7.8,0,288500217,75000000,213500217,1
194,45223,793059,2528,7.7,26000,1845034188,200000000,1645034188,1
169,44998,881236,2277,8.6,22000,481840909,70000000,411840909,1
142,33284,382255,1504,7.8,11000,789804554,130000000,659804554,1
106,20821,740918,1182,8.6,28000,23341568,6000000,17341568,1
102,20330,72803,171,7.3,33000,54837234,13000000,41837234,1
124,24098,456260,2326,7,97000,403170142,130000000,273170142,1
158,2144,283418,1055,5.8,13000,769653595,200000000,569653595,1
108,55486,234480,444,6.4,3000,574480841,110000000,464480841,1
96,1411,26767,121,5.1,0,72629670,25000000,47629670,1
118,3425,316671,301,7,35000,269994119,37000000,232994119,1
130,63986,844052,1100,8.5,49000,109676311,40000000,69676311,1
106,16922,58752,117,6,21000,140396650,90000000,50396650,1
113,46355,270226,741,6.5,57000,274470394,80000000,194470394,1
122,44060,348007,1535,5.2,19000,392616625,37000000,355616625,1
112,15327,93767,209,7.2,34000,42629776,25000000,17629776,1
74,19046,623757,391,8.3,0,361958736,30000000,331958736,1
109,17689,338087,814,6.6,61000,286140700,115000000,171140700,1
94,3559,469561,514,8.2,21000,16491080,4000000,12491080,1
122,14959,333847,2054,6.2,5000,786636033,185000000,601636033,1
185,15233,865020,1273,8.9,41000,321265768,22000000,299265768,1
135,2827,610568,1171,8.2,29000,313542341,60000000,253542341,1
117,4905,263853,584,7.2,0,461983149,120000000,341983149,1
106,21195,32507,119,7.5,15000,46152800,23000000,23152800,1
138,33433,355137,1108,7.5,0,938212738,150000000,788212738,1
92,5178,138582,423,6.3,37000,215529201,70000000,145529201,1
124,34817,256695,871,6.9,0,397850012,150000000,247850012,1
102,23378,221128,343,7.9,46000,609123048,145000000,464123048,1
101,15481,165618,503,5.3,66000,304654182,92000000,212654182,1
132,72881,228554,710,6.1,53000,396600000,170000000,226600000,1
108,1885,422432,1040,8.5,18000,3.2e+07,806948,31193052,1
117,2357,435864,801,7.7,36000,96188903,28000000,68188903,1
130,1784,199025,416,7.2,0,352194034,58000000,294194034,1
128,2037,157519,683,6.4,2000,361832400,135000000,226832400,1
85,3708,139329,578,5.7,31000,89328627,3000000,86328627,1
130,1164,82073,275,7,0,141195658,11000000,130195658,1
150,1317,286506,1463,6.9,0,748806957,180000000,568806957,1
146,24783,728685,989,8.7,25000,46836394,25000000,21836394,1
112,21773,471644,623,7,74000,549368315,50000000,499368315,1
127,39284,504419,1559,8,19000,385680446,150000000,235680446,1
90,52970,260939,244,8,0,504050219,28000000,476050219,1
131,52610,127258,351,6.1,56000,206172544,90000000,116172544,1
174,35672,387616,858,7.4,0,876688482,100000000,776688482,1
100,14168,158720,744,4.9,37000,243843127,130000000,113843127,1
123,32392,465019,995,7,129000,531865000,200000000,331865000,1
92,15013,585659,593,8.1,0,562816256,115000000,447816256,1
108,3033,50056,152,6.3,0,32556119,15000000,17556119,1
129,1062,364948,2121,6.7,0,424988211,150000000,274988211,1
123,63769,115216,289,7,44000,99775678,53000000,46775678,1
130,64040,220758,919,4.6,13000,709827462,50000000,659827462,1
121,36010,130661,304,7.2,54000,194564672,35000000,159564672,1
129,22403,338635,412,7.5,39000,334615000,125000000,209615000,1
105,13118,403836,646,7.6,47000,482860185,93000000,389860185,1
186,9152,483540,951,7.9,83000,958400000,250000000,708400000,1
109,1769,305340,1676,6.4,0,4.35e+08,200000000,2.35e+08,1
115,1815,194249,253,6.9,0,660940780,80000000,580940780,1
90,21015,182718,209,7.3,20000,665692281,150000000,515692281,1
142,49942,701607,1959,7.3,140000,691210692,75000000,616210692,1
88,14823,270207,606,6.1,2000,441818803,140000000,301818803,1
119,31782,203154,698,6.5,45000,161025640,70000000,91025640,1
108,38072,551363,1140,8,106000,327803731,13000000,314803731,1
93,15192,172489,376,7.7,0,125212904,15000000,110212904,1
90,275,467113,945,7.9,0,484409218,60000000,424409218,1
117,17738,326494,340,8,65000,55198285,5000000,50198285,1
153,28489,451803,1225,7,56000,752215857,215000000,537215857,1
93,17925,85323,212,5.8,0,101702060,45000000,56702060,1
104,39175,600996,726,8.3,27000,83557872,10000000,73557872,1
126,2899,215255,610,7,0,2.8e+08,80000000,2e+08,1
125,62837,101178,779,6,90000,212902372,50000000,162902372,1
130,10247,107028,457,6,44000,90565421,60000000,30565421,1
104,21380,90938,271,6.5,0,114194847,12000000,102194847,1
88,28011,386217,553,7.7,26000,102391382,23600000,78791382,1
129,1450,94241,309,6.3,25000,140795793,35000000,105795793,1
100,18786,4654,46,6.7,18000,109387615,20000000,89387615,1
123,11930,242188,1426,6.1,0,546388105,125000000,421388105,1
98,16410,238671,461,6.3,63000,376141306,45000000,331141306,1
109,2753,63390,160,6.4,0,85512300,12000000,73512300,1
128,1058,195333,409,8.1,80000,88346473,20000000,68346473,1
161,727,427357,1736,8.3,24000,56715371,12000000,44715371,1
140,44042,520104,3286,7.6,10000,8.5e+08,113000000,7.37e+08,1
93,5005,273556,428,7.2,39000,538983207,185000000,353983207,1
100,11471,212167,713,7,0,64238440,15000000,49238440,1
114,2085,265818,213,6.9,0,351583407,23000000,328583407,1
93,16034,379462,571,7.5,56000,147332697,32000000,115332697,1
135,5811,326286,643,6.8,0,163712074,150000000,13712074,1
103,5497,47968,154,6.4,35000,150170815,58000000,92170815,1
145,16094,375240,542,8.1,0,117235147,1100000,116135147,1
108,17623,583341,626,7.8,24000,459270619,35000000,424270619,1
117,47728,537419,1028,8.2,35000,27739163,15000000,12739163,1
156,3244,211765,546,6.7,17000,310669540,200000000,110669540,1
167,2702,119928,331,7.9,76000,201634991,28000000,173634991,1
128,51609,277451,491,8,23000,235860116,16400000,219460116,1
123,23031,77394,195,7.4,24000,61181942,35000000,26181942,1
93,27834,117999,181,6.6,16000,51070807,40000000,11070807,1
127,12884,515306,477,8.3,0,474171806,48000000,426171806,1
99,28994,664719,931,8.4,19000,14661007,1200000,13461007,1
104,14863,235025,265,7.3,44000,743559607,200000000,543559607,1
119,22767,219008,418,7.9,0,76270454,25000000,51270454,1
92,5217,34359,133,6,16000,311594032,74000000,237594032,1
107,17540,704766,2073,8.1,14000,672806292,40000000,632806292,1
133,2538,169914,1185,6.1,0,431971116,140000000,291971116,1
145,12546,399651,1331,7.7,0,358372926,102000000,256372926,1
138,83012,358416,751,7.3,63000,251171807,40000000,211171807,1
123,34495,396396,1111,7.9,57000,115603229,29000000,86603229,1
130,16385,226570,448,7,38000,218340595,60000000,158340595,1
157,53413,385670,1896,7.6,0,895921036,150000000,745921036,1
135,12175,229823,504,6.7,31000,276572938,130000000,146572938,1
121,2880,190786,539,5.4,0,336529144,100000000,236529144,1
147,3924,656640,1732,8.1,13000,158733820,40000000,118733820,1
102,21584,343648,590,6.4,0,624029371,150000000,474029371,1
101,4451,272534,345,7.8,40000,471222889,165000000,306222889,1
157,2759,216032,640,7.4,39000,132820716,40000000,92820716,1
94,3552,23473,123,4.4,8000,107275897,30000000,77275897,1
82,21275,385871,515,7.9,0,485015179,90000000,395015179,1
108,19364,666937,1514,8.3,52000,72258126,20000000,52258126,1
112,12676,213898,250,7.2,36000,115350426,17000000,98350426,1
116,13028,402645,845,7.8,0,450717150,85000000,365717150,1
93,578,20837,127,4.8,10000,30894815,10000000,20894815,1
138,20952,264047,491,7.3,64000,161772375,31000000,130772375,1
138,534,421818,2789,7.2,0,738599701,150000000,588599701,1
88,25354,145321,139,6.6,14000,877244782,95000000,782244782,1
93,4628,138661,173,6.4,0,752600867,165000000,587600867,1
110,1198,139432,418,7.8,0,124900000,3500000,121400000,1
102,2998,156225,502,6.8,0,111340801,50000000,61340801,1
130,2047,412454,962,8,21000,470654000,7000000,463654000,1
90,1227,152601,156,7,0,242988466,100000000,142988466,1
122,28933,93548,307,7.2,23000,34441873,30000000,4441873,1
94,1258,166791,132,7,0,886686817,90000000,796686817,1
119,37387,428916,667,7.4,75000,47042000,30000000,17042000,1
106,10882,86627,204,5.9,28000,174578751,90000000,84578751,1
174,16008,314253,1966,6.6,0,758239851,125000000,633239851,1
153,26029,322395,1171,6.6,11000,553799566,140000000,413799566,1
151,45648,873649,2054,8.5,29000,289847354,90000000,199847354,1
90,63165,132415,288,6,0,367275019,75000000,292275019,1
125,19359,284852,627,6.4,0,362744280,110000000,252744280,1
131,3229,218711,485,6.8,27000,288383523,32500000,255883523,1
92,27572,237248,460,6.8,0,43928932,21000000,22928932,1
99,23562,16984,96,5.3,0,78636257,29000000,49636257,1
146,16948,207839,435,6.7,0,356613439,150000000,206613439,1
114,12908,184561,554,6.7,123000,125537191,110000000,15537191,1
153,58753,321795,973,7.5,10000,933959197,250000000,683959197,1
132,27659,87682,174,7,43000,42972994,25000000,17972994,1
130,1233,69457,271,6.7,0,191185897,40000000,151185897,1
99,40312,66123,219,6.1,28000,104384188,31000000,73384188,1
109,20148,156898,172,6.7,22000,131940411,61000000,70940411,1
111,995,73249,212,7.5,36000,62076141,11000000,51076141,1
189,17716,782610,1377,8.5,30000,284600000,60000000,224600000,1
94,1010,65299,455,6.2,27000,98450062,5000000,93450062,1
106,16967,200647,384,7,24000,222809600,50000000,172809600,1
130,15972,248045,890,6.3,0,433013274,98000000,335013274,1
120,42028,291603,505,8.1,9000,138530565,6000000,132530565,1
119,54031,172707,462,6.3,37000,103039258,100000000,3039258,1
130,3133,452465,695,7.7,89000,232324128,44500000,187824128,1
109,16179,97045,285,5.7,55000,169837010,40000000,129837010,1
124,43453,198066,426,7.6,13000,83282296,53000000,30282296,1
129,13961,336235,782,7.2,0,383531464,110000000,273531464,1
111,35084,285623,497,7,0,176070171,60000000,116070171,1
141,48153,525801,667,8,15000,352114312,52000000,300114312,1
140,2114,124242,622,6.5,4000,54700105,33000000,21700105,1
123,14727,232710,599,7.7,26000,168167691,55000000,113167691,1
142,42990,464310,3516,6.7,0,649398328,120000000,529398328,1
93,1148,314630,483,7.2,0,919838758,150000000,769838758,1
143,15838,394317,1051,7.7,23000,429632142,90000000,339632142,1
117,16325,172878,203,6.4,19000,214918407,80000000,134918407,1
131,13679,255447,692,6.9,0,347451894,100000000,247451894,1
103,57881,246803,474,6.7,108000,312573423,100000000,212573423,1
117,2127,75280,267,6.9,0,111584787,9500000,102084787,1
131,2943,68565,300,6.3,0,152427960,30000000,122427960,1
123,14100,265507,388,7.7,90000,121201940,15000000,106201940,1
115,15708,177653,279,6.7,34000,122915111,50000000,72915111,1
96,20007,146766,178,6.9,0,309979994,150000000,159979994,1
124,22004,387436,892,7,71000,286168572,120000000,166168572,1
85,3958,296787,2192,7,0,170764026,25000000,145764026,1
103,19085,544884,733,8.3,30000,1063171911,200000000,863171911,1
110,12760,300542,378,7.1,0,457696359,80000000,377696359,1
122,4738,612060,1518,8.1,21000,171600000,25000000,146600000,1
117,33154,102747,316,5.5,0,156505388,95000000,61505388,1
110,23525,507063,881,8.3,35000,28262574,1300000,26962574,1
109,34011,304318,463,6.7,52000,173930596,40000000,133930596,1
96,15662,117606,217,6.4,0,300400432,44000000,256400432,1
138,32355,200022,1240,5.8,71000,362637473,125000000,237637473,1
108,23296,219091,592,7.3,12000,25836616,19000000,6836616,1
79,1594,111117,245,7.1,13000,48428063,30000000,18428063,1
132,1112,244566,597,6.8,0,99318987,66000000,33318987,1
134,16281,323353,527,7.9,65000,9.5e+07,55000000,4e+07,1
91,37142,164148,168,7.1,28000,358375603,85000000,273375603,1
120,10555,479453,696,7.7,74000,224920315,40000000,184920315,1
153,37321,383591,620,8.1,86000,122126687,46000000,76126687,1
162,36928,301279,589,7.7,12000,84785914,65000000,19785914,1
128,29824,174248,263,7.1,0,113280098,70000000,43280098,1
184,5401,254111,1999,6.1,0,449220945,140000000,309220945,1
112,19428,258186,322,7.1,24000,188441614,50000000,138441614,1
152,4270,292022,1103,7.7,10000,172989651,92000000,80989651,1
88,309,27918,155,7.2,33000,246233113,99000000,147233113,1
122,43499,256928,288,6.9,0,311312624,85000000,226312624,1
98,43286,150618,195,7.3,28000,585178928,135000000,450178928,1
111,28643,166610,211,6.4,0,73762516,45000000,28762516,1
99,4863,45394,72,6.5,19000,140470746,33000000,107470746,1
124,52547,184637,498,4.9,29000,698491347,68000000,630491347,1
196,17944,381672,1694,7.2,0,497409852,175000000,322409852,1
107,568,114925,234,7.1,13000,101229792,39000000,62229792,1
140,11951,188116,415,7.3,0,250649836,90000000,160649836,1
125,16138,350698,816,8,26000,122919055,70000000,52919055,1
95,23018,272789,285,6.6,25000,211780824,65000000,146780824,1
123,1326,76477,275,7.1,0,185438673,14000000,171438673,1
101,3858,782437,1420,8.6,35000,23875127,20000000,3875127,1
154,4228,488537,1076,8.4,18000,131060248,18500000,112560248,1
110,25763,299852,713,6.7,0,258270008,75000000,183270008,1
146,2560,610333,1320,8.4,37000,44017374,19000000,25017374,1
289,25313,450676,983,8.5,19000,83471511,31500000,51971511,1
100,39989,82804,154,6.5,15000,43058898,22000000,21058898,1
216,47657,314033,1166,7.5,0,193772504,100000000,93772504,1
127,2121,440084,755,8,122000,609016565,120000000,489016565,1
102,25462,357275,1061,7.6,18000,34266564,7000000,27266564,1
117,49743,87165,184,6.5,12000,123494610,40000000,83494610,1
97,16999,171568,571,6.7,0,281929795,25000000,256929795,1
96,10886,54010,130,6.1,13000,240360392,50000000,190360392,1
122,19078,822500,2715,8.4,22000,356296601,15000000,341296601,1
124,20553,333248,1159,6.4,19000,544272402,125000000,419272402,1
126,39319,343274,742,7.7,18000,263920180,90000000,173920180,1
137,2938,103589,351,7.2,35000,163442937,65000000,98442937,1
126,22722,348861,798,6.5,0,478207520,110000000,368207520,1
133,2371,74009,317,6.6,0,156167015,32000000,124167015,1
116,17347,561773,871,8.2,28000,269958228,33000000,236958228,1
89,26839,56501,97,6.7,16000,466183544,80000000,386183544,1
100,12150,157016,824,5.7,0,274703340,115000000,159703340,1
99,1375,213863,310,6.4,59000,179379533,65000000,114379533,1
118,26683,174578,534,5.8,0,302469017,175000000,127469017,1
78,2039,128285,297,7.3,0,169327687,100000000,69327687,1
97,5547,160418,296,5.7,16000,216197492,20000000,196197492,1
111,24928,238916,328,7.1,32000,71664962,58000000,13664962,1
108,3660,340085,327,7.8,12000,3.32e+08,40000000,2.92e+08,1
178,1976,736638,1065,8.4,17000,2.1e+08,72000000,1.38e+08,1
109,14073,155745,1053,6.8,10000,104478416,50000000,54478416,1
94,2259,13562,103,6.1,19000,88923251,18000000,70923251,1
115,1554,78008,160,6.7,23000,97594140,28000000,69594140,1
83,25788,124641,289,6.6,0,171757863,60000000,111757863,1
114,5095,236421,515,7.3,70000,188133322,90000000,98133322,1
116,20233,189806,316,6.7,16000,170432927,100000000,70432927,1
97,2480,89351,214,7.1,5000,267045765,105000000,162045765,1
172,22686,284825,828,7.5,124000,130482868,102000000,28482868,1
122,72115,533607,692,7.8,117000,205738714,21000000,184738714,1
101,956,268581,1109,7.6,20000,209947037,17000000,192947037,1
109,17866,33856,147,7.3,34000,61619773,11000000,50619773,1
96,12071,165333,186,7,19000,484635760,90000000,394635760,1
118,14024,141179,419,5.9,9000,226497209,95000000,131497209,1
106,1819,57349,177,6.4,0,32248241,12000000,20248241,1
119,2958,149680,328,6.5,0,333011068,110000000,223011068,1
101,36892,51326,116,6.5,8000,43528634,8500000,35028634,1
128,7067,197584,918,6.1,42000,89792502,82000000,7792502,1
120,820,641997,1017,8,13000,377910544,15000000,362910544,1
105,26233,165792,392,6.7,44000,31327899,20000000,11327899,1
116,16149,222403,453,6.6,23000,335154643,150000000,185154643,1
109,20956,270228,194,6.6,41000,150483765,35000000,115483765,1
122,1484,52894,185,7.3,55000,88880821,22000000,66880821,1
127,17551,125305,343,6.4,39000,98337295,38000000,60337295,1
116,12758,334345,2741,6.5,0,591739379,132000000,459739379,1
133,12285,383784,331,8,12000,354825435,25000000,329825435,1
92,2184,119974,169,6.6,0,91327197,35000000,56327197,1
120,1105,74249,276,6.7,0,1.16e+08,7200000,108800000,1
109,23923,286178,631,6.8,0,326551094,35000000,291551094,1
102,16143,375879,402,6.5,56000,254455986,80000000,174455986,1
119,20391,166269,735,7.7,0,85306374,15000000,70306374,1
127,22254,254841,426,7.1,36000,299268508,110000000,189268508,1
106,14607,200035,407,7.1,36000,127869379,50200000,77669379,1
133,2176,680041,760,8.7,32000,108981275,3000000,105981275,1
94,11984,279179,440,7.6,63000,35692920,18000000,17692920,1
88,4478,171792,222,7.5,12000,304320254,90000000,214320254,1
102,24107,34964,150,4.8,28000,55969000,50000000,5969000,1
126,1008,69534,294,6.3,0,210300000,34000000,176300000,1
87,3086,259083,763,7.4,0,527068851,75000000,452068851,1
88,15001,112167,123,6.3,0,2.3e+08,80000000,1.5e+08,1
95,24205,211226,317,7.2,0,363398565,120000000,243398565,1
100,22128,246698,471,7.8,64000,469160692,60000000,409160692,1
110,4210,295375,645,7.6,15000,86915017,40000000,46915017,1
123,4825,133177,380,6.6,24000,158674180,43000000,115674180,1
97,37907,222099,549,7.2,10000,53478166,16000000,37478166,1
107,4631,177383,447,7.4,44000,371940071,130000000,241940071,1
90,5046,114287,137,6.7,16000,554987477,130000000,424987477,1
123,14017,182661,681,5.2,0,228738393,110000000,118738393,1
118,44797,227072,560,6.9,20000,157107755,80000000,77107755,1
115,38963,38202,135,5.7,41000,122413057,14800000,107613057,1
84,3629,111526,347,5.5,0,220673217,48000000,172673217,1
96,28817,414335,881,7.5,10000,231411584,7500000,223911584,1
136,37723,534658,3597,6.5,13000,924317558,115000000,809317558,1
123,20499,192930,581,7.8,12000,129266061,30000000,99266061,1
120,7860,200077,189,6.6,0,358991681,18000000,340991681,1
165,673,266020,836,8,92000,44349000,4000000,40349000,1
112,3388,287822,849,7.1,37000,260095987,50000000,210095987,1
117,13877,461609,1168,8.2,34000,32768670,28000000,4768670,1
101,1031,58498,99,6.4,0,500188435,103000000,397188435,1
113,1441,240241,391,7.5,0,261317921,65000000,196317921,1
87,24770,139114,245,7.8,15000,46471023,40000000,6471023,1
96,1433,447785,888,8.9,40000,1e+06,340000,660000,1
148,18752,426359,760,8.2,76000,56255142,15000000,41255142,1
109,15608,195043,329,6.1,27000,144492830,50000000,94492830,1
131,18204,164238,434,6.4,33000,205366737,150000000,55366737,1
88,2726,160281,427,7.8,16000,83453539,3500000,79953539,1
116,20966,260981,373,7.2,0,350448145,30000000,320448145,1
121,1865,74957,251,6.8,0,161777836,7000000,154777836,1
125,17611,73950,258,6.8,2000,97572000,7000000,90572000,1
113,17152,210542,332,6.9,29000,130786397,30000000,100786397,1
127,2129,613473,895,8.1,19000,920100000,63000000,857100000,1
131,28544,277505,495,8.3,10000,159157447,14000000,145157447,1
87,14574,92106,171,5.7,2000,189015611,63000000,126015611,1
81,3344,13523,95,6.9,0,44107032,4900000,39207032,1
86,2070,220392,243,6.8,0,1.81e+08,45000000,1.36e+08,1
121,23484,307539,577,7,0,188072649,92000000,96072649,1
89,3285,146019,119,6.7,0,603900354,150000000,453900354,1
126,18726,167967,243,7.1,20000,156835339,30000000,126835339,1
91,3969,177828,714,7.3,11000,90259536,30000000,60259536,1
104,13076,530870,1413,7.2,11000,585349010,150000000,435349010,1
143,16007,63330,405,6.4,0,1.39e+08,35000000,1.04e+08,1
82,3442,387508,1123,8.6,23000,10462500,950000,9512500,1
106,33645,245152,1344,7.2,0,248118121,75000000,173118121,1
101,12406,245621,514,6.4,23000,293329073,110000000,183329073,1
110,10438,194422,1057,7.4,7000,102356381,28000000,74356381,1
103,692,66593,153,5.5,31000,563749323,110000000,453749323,1
176,20354,324671,458,7.8,0,266465037,100000000,166465037,1
169,29991,240396,2367,6.1,0,391081192,270000000,121081192,1
101,1026,140740,151,6.1,0,1.7e+08,35000000,1.35e+08,1
116,23811,275869,389,7.9,36000,129190869,25000000,104190869,1
150,25517,197412,720,7.4,71000,275293450,65000000,210293450,1
108,22739,168717,178,6.2,24000,147780440,25000000,122780440,1
95,16884,66308,225,5.5,0,113006880,56000000,57006880,1
95,29551,277172,986,7,66000,66486080,30000000,36486080,1
128,16199,303864,596,7.3,16000,219417255,60000000,159417255,1
94,15419,145350,643,5.5,0,264105545,92000000,172105545,1
83,229,133348,204,7.7,0,184925486,1488423,183437063,1
180,3076,270790,549,8.3,16000,51973029,18000000,33973029,1
146,23227,318955,460,8.1,75000,124272124,25000000,99272124,1
117,15590,255257,374,7,0,42431017,27000000,15431017,1
102,13631,351274,457,8,131000,33400000,13000000,20400000,1
118,15732,503631,636,8,64000,414211549,15000000,399211549,1
132,14790,142569,737,5.8,10000,277448382,70000000,207448382,1
107,389,12276,117,6.3,21000,46069568,20000000,26069568,1
89,18132,151424,252,6.3,0,122444772,80000000,42444772,1
201,7123,316018,2618,7.2,0,5.5e+08,207000000,3.43e+08,1
127,2118,72085,263,6.8,2000,195312802,28000000,167312802,1
110,13069,219171,388,6.9,19000,356830601,15000000,341830601,1
92,2848,9509,53,3.5,11000,21164799,20000000,1164799,1
89,13794,79094,129,5.4,0,114663461,30000000,84663461,1
148,2566,142448,319,7.9,14000,115229890,27000000,88229890,1
95,4134,188679,864,6.6,0,152925093,4000000,148925093,1
147,12954,178126,511,6.6,0,273339556,130000000,143339556,1
138,1814,212106,1445,5.7,0,245360480,137000000,108360480,1
108,7872,200260,431,6.4,0,287553595,30000000,257553595,1
109,7833,6276,55,6.8,16000,7.7e+07,16000000,6.1e+07,1
107,38751,310540,669,6.7,97000,126041322,32000000,94041322,1
93,4701,95294,363,7.8,12000,119500000,2600000,116900000,1
99,1686,395921,859,8,19000,30039392,4000000,26039392,1
107,24805,92712,294,5.1,6000,31556061,16000000,15556061,1
106,18669,353442,387,6.9,31000,1.17e+08,35000000,8.2e+07,1
121,23008,235133,494,8.3,0,2.3e+07,18000000,5e+06,1
106,22590,172217,405,6.3,0,101371017,70000000,31371017,1
138,27797,80861,431,5.3,24000,71009334,25000000,46009334,1
101,1272,139184,243,6.4,12000,64572262,36000000,28572262,1
92,3165,65709,194,5.1,15000,71154592,65000000,6154592,1
93,2043,157051,261,6.7,29000,1e+08,12000000,8.8e+07,1
113,8398,172112,181,6.7,39000,234989584,50000000,184989584,1
136,15999,259492,415,7.4,51000,335062621,75000000,260062621,1
92,2847,57276,146,5.2,0,361366633,60000000,301366633,1
84,3416,87494,540,6.1,0,28650575,12600000,16050575,1
106,4482,101178,283,6.3,10000,559852396,200000000,359852396,1
128,70,18656,137,6.7,933,1.3e+07,3000000,1e+07,1
99,2323,81699,291,5.4,45000,255273813,6500000,248773813,1
131,1898,74374,225,6.6,0,183700000,27500000,156200000,1
129,2031,221521,1049,7.2,0,121214377,105000000,16214377,1
118,27114,98472,492,5.9,0,105316267,88000000,17316267,1
93,4705,211971,326,6.1,0,798958165,160000000,638958165,1
131,26679,202382,751,5.9,44000,303025485,209000000,94025485,1
83,1645,119590,548,5.2,0,141220678,45000000,96220678,1
120,3632,208422,342,7,3000,160388063,85000000,75388063,1
93,2444,119213,154,6.9,17000,746921274,145000000,601921274,1
100,16264,120798,444,6.6,10000,305875730,165000000,140875730,1
128,3386,50041,116,7.1,23000,63013281,34000000,29013281,1
88,1178,90360,147,7.5,0,84300000,2600000,81700000,1
95,15237,72591,289,6.8,0,186053725,120000000,66053725,1
138,17087,283967,535,7.3,11000,245676146,80000000,165676146,1
119,11013,172405,203,6.8,0,141407024,19000000,122407024,1
91,1804,103022,269,6.3,0,260696994,75000000,185696994,1
122,22370,305929,633,7.7,0,104876233,45000000,59876233,1
110,4714,141533,786,5.8,0,179265204,78000000,101265204,1
102,28497,181443,311,6,12000,271430189,80000000,191430189,1
140,17171,208817,296,7.6,5000,355237933,52000000,303237933,1
97,36064,86251,260,6.5,58000,66980456,25000000,41980456,1
100,2036,294810,387,7.8,29000,591794936,260000000,331794936,1
103,55175,176598,374,6,25000,278346189,100000000,178346189,1
119,17584,422606,555,7.6,0,169860655,20000000,149860655,1
118,16758,217507,325,7.2,0,105173115,30000000,75173115,1
98,337,184641,326,6.9,81000,116980662,35000000,81980662,1
103,5161,299127,1509,7.7,0,103911669,1200000,102711669,1
99,12952,266103,456,6.8,11000,196482882,75000000,121482882,1
136,45271,259519,431,7.5,11000,152944660,57000000,95944660,1
117,11036,338383,611,8,32000,307077295,55000000,252077295,1
146,6217,238747,2153,7.1,11000,235926552,100000000,135926552,1
107,20466,83893,132,6.8,15000,78874843,11000000,67874843,1
119,29461,176169,548,6.6,0,144056873,40000000,104056873,1
84,26754,119675,216,6.6,0,346079773,55000000,291079773,1
110,14609,209133,962,7.6,0,71441250,21000000,50441250,1
123,15362,225282,339,6.8,0,224012234,75000000,149012234,1
110,16691,138190,405,6.1,30000,226904017,75000000,151904017,1
107,1529,101840,193,6.2,0,36230219,12305523,23924696,1
95,5286,88529,262,5.8,0,113857533,10800000,103057533,1
110,25964,240962,724,7.7,36000,252276927,38000000,214276927,1
107,14710,43743,293,5.4,0,70200000,30000000,40200000,1
94,1024,76791,100,6.1,0,26049082,8000000,18049082,1
88,2217,33042,90,5.1,0,292817841,150000000,142817841,1
119,15449,61621,219,7.3,0,1.33e+08,24000000,1.09e+08,1
114,1766,106416,205,6.3,22000,197687603,195000000,2687603,1
150,22697,149922,438,6.6,0,419651413,225000000,194651413,1
101,21276,296904,604,6.7,0,484572835,80000000,404572835,1
103,259,48675,214,6.8,16000,54418872,5000000,49418872,1
110,3174,191437,582,7.1,0,131183530,45000000,86183530,1
188,12940,126357,497,7.3,0,300218018,55000000,245218018,1
150,1075,497946,761,8.5,21000,120072577,35000000,85072577,1
110,911,171151,513,6.8,0,30411183,25000000,5411183,1
103,4722,105478,291,6.2,0,57120318,35000000,22120318,1
171,4074,131217,380,7.6,0,90000098,70000000,20000098,1
119,13391,136019,443,5.8,14000,227817248,120000000,107817248,1
109,390,192462,334,7,42000,97552050,40000000,57552050,1
125,11135,213476,271,6.9,11000,4.63e+08,14000000,4.49e+08,1
87,16571,53786,211,6.3,0,95608995,34000000,61608995,1
114,7099,145270,322,7.6,54000,180274123,42000000,138274123,1
127,2601,224013,2319,7.6,10000,179213434,52500000,126713434,1
96,22436,163665,169,6.5,9000,205298907,38000000,167298907,1
117,16828,200359,1009,7.7,0,181001478,80000000,101001478,1
102,5178,28621,58,5.9,0,1.24e+08,40000000,8.4e+07,1
120,12755,357579,1100,7.7,15000,96060858,13000000,83060858,1
105,8281,128629,348,5.9,98000,112265139,69000000,43265139,1
104,18322,145852,164,6.8,32000,196114570,30000000,166114570,1
113,34738,173530,264,6.7,40000,105200903,60000000,45200903,1
129,1397,261069,506,7.8,25000,109423648,50000000,59423648,1
161,1035,149444,273,8.2,0,33300000,3000000,30300000,1
120,22750,135601,493,6.1,0,140464664,75000000,65464664,1
121,762,48636,214,6.2,0,1.6e+08,36000000,1.24e+08,1
108,24286,260442,507,7,0,330444045,55000000,275444045,1
103,2857,118951,1382,4.2,18000,318502923,150000000,168502923,1
124,13864,161972,356,8.2,9000,26010864,5000000,21010864,1
96,3151,40883,122,6.8,11000,108255770,60000000,48255770,1
110,2239,155153,524,6.8,58000,77712439,3000000,74712439,1
101,638,149835,243,6.6,0,42105111,24000000,18105111,1
92,16982,276746,264,7.1,19000,74952305,8000000,66952305,1
110,1954,187181,564,7,0,2.15e+08,41000000,1.74e+08,1
121,1261,203963,420,7.6,58000,149295601,40000000,109295601,1
127,6171,127497,287,6.6,0,285444603,140000000,145444603,1
96,1919,103787,615,5.9,3000,123729176,80000000,43729176,1
107,662,142496,399,7.1,0,340487652,85000000,255487652,1
106,561,65044,173,5,13000,82087155,35000000,47087155,1
99,663,21034,153,5.8,23000,101332962,12000000,89332962,1
98,14007,43328,110,5.7,0,106303988,50000000,56303988,1
98,4567,29867,181,6.2,27000,61548707,15000000,46548707,1
82,2945,38438,241,6.5,0,354248063,127500000,226748063,1
98,20453,485430,492,8.2,33000,494878759,165000000,329878759,1
113,80849,199039,479,6.2,82000,245527149,150000000,95527149,1
92,1953,189413,306,7.5,15000,73326666,15000000,58326666,1
113,764,106446,227,6.3,11000,415686217,155000000,260686217,1
118,13426,244840,372,6.6,0,368100420,70000000,298100420,1
147,8484,235992,1768,8,16000,20117339,15000000,5117339,1
116,32563,58023,281,6.3,0,116672912,70000000,46672912,1
141,12840,199056,387,7.8,14000,113020255,55000000,58020255,1
114,46944,194489,192,7.3,12000,25739015,18000000,7739015,1
188,1906,241030,1437,8,13000,48451803,37000000,11451803,1
104,29505,271691,243,6.8,0,225990978,70000000,155990978,1
129,20056,86422,363,6.6,0,96105964,80000000,16105964,1
107,43291,183208,337,7.2,26000,245724603,135000000,110724603,1
108,16031,52888,175,6.5,0,35424826,22000000,13424826,1
88,5227,31649,98,4.5,2000,443140005,75000000,368140005,1
136,34839,263329,899,6.9,0,162949164,126000000,36949164,1
124,23603,146134,393,6.4,0,315156409,85000000,230156409,1
121,13421,186879,791,6.2,0,155446362,50000000,105446362,1
109,26625,101977,161,6.5,0,63100000,25000000,38100000,1
136,12396,135404,318,6.7,0,250288523,95000000,155288523,1
154,11945,317166,928,7.7,0,456758981,140000000,316758981,1
96,2936,136667,273,7.1,13000,38119483,22700000,15419483,1
91,2158,382240,660,8.3,14000,5028948,400000,4628948,1
125,33865,178731,261,7.7,0,206678440,26000000,180678440,1
95,1991,342585,839,8.5,18000,9440272,1800000,7640272,1
142,19454,207613,1144,7.1,4000,215294342,110000000,105294342,1
139,1474,224671,470,7.7,11000,314178011,50000000,264178011,1
133,53094,283563,312,7.6,27000,110206216,50000000,60206216,1
81,399,186786,3400,6.4,0,2.48e+08,25000,247975000,1
90,664,160440,394,6.6,0,347325802,90000000,257325802,1
115,9578,205284,439,7.3,22000,177243185,20000000,157243185,1
162,15912,142067,457,7.4,0,231976425,27000000,204976425,1
95,8134,315549,789,7,0,235483004,11000000,224483004,1
96,28071,110390,522,7.2,6000,137587063,60000000,77587063,1
150,12289,200556,611,7.4,15000,171120329,90000000,81120329,1
118,57426,375456,292,7.4,44000,142851197,50000000,92851197,1
98,7461,115050,911,5.9,4000,183474602,10000000,173474602,1
206,24598,138863,1390,5.5,0,167298192,155000000,12298192,1
97,5032,245989,554,7,0,129042871,17000000,112042871,1
140,20440,63493,302,5.7,26000,204594016,60000000,144594016,1
154,25522,239540,462,7.5,0,39673162,12000000,27673162,1
98,2630,136580,545,7.6,15000,9.4e+07,15000000,7.9e+07,1
146,46726,116159,488,7.2,28000,177584879,66000000,111584879,1
128,14747,109188,625,7,0,9.4e+07,50000000,4.4e+07,1
96,3492,111087,319,5.9,0,139352633,10000000,129352633,1
132,7081,136954,346,6.5,32000,203277636,66000000,137277636,1
110,21554,96565,135,5.5,0,1.36e+08,40000000,9.6e+07,1
96,3119,90070,248,7.1,11000,48572000,11000000,37572000,1
106,2270,91017,284,7.2,0,5e+07,6000000,4.4e+07,1
98,6742,122187,339,6.1,0,96455697,37000000,59455697,1
96,3013,20885,60,6.1,0,11122090,6000000,5122090,1
113,13446,156348,380,5.5,0,201596308,90000000,111596308,1
104,12170,92074,502,6.4,0,40283321,15000000,25283321,1
125,52201,181380,223,6.9,0,441286195,25000000,416286195,1
87,1461,114692,285,6.1,2000,160583018,40000000,120583018,1
115,74382,80580,375,6.7,0,202292902,50000000,152292902,1
111,2978,124501,154,6.1,0,160259319,30000000,130259319,1
131,1520,51314,265,5.7,0,187884007,20000000,167884007,1
121,1323,150308,498,7.3,18000,152500343,25000000,127500343,1
100,17902,198701,1138,6.7,0,102441078,33000000,69441078,1
107,14006,60476,97,5.9,0,157920733,60000000,97920733,1
87,29050,156267,340,6.3,0,85167639,32000000,53167639,1
89,5855,93748,410,5.1,1000,178262620,45000000,133262620,1
103,19168,202967,378,6.6,36000,2.9e+07,28000000,1e+06,1
143,33160,400292,657,8,14000,170877916,100000000,70877916,1
139,5458,54096,494,7.5,0,68296293,22000000,46296293,1
142,1769,59941,452,6.8,0,81974493,7000000,74974493,1
236,2398,186485,382,8,0,424208848,22000000,402208848,1
111,4696,156929,624,7.7,14000,27200316,27000000,200316,1
129,19148,273108,646,7.6,0,184376254,45000000,139376254,1
106,1675,271592,2335,6.7,0,408247917,72000000,336247917,1
77,368,72639,371,7,19000,424760,7000,417760,1
101,74,144021,391,7.1,0,1.29e+08,27000000,1.02e+08,1
109,13388,124185,238,6.1,11000,215283742,150000000,65283742,1
107,4046,100821,554,4.8,0,259175788,120000000,139175788,1
99,12831,72326,116,6.1,0,212874442,80000000,132874442,1
129,2387,175607,252,8.3,0,159616327,5500000,154116327,1
88,33822,30055,70,5.9,593,55181129,50000000,5181129,1
99,16184,152826,253,5.8,19000,3.01e+08,150000000,1.51e+08,1
113,103354,93790,288,6.6,0,77944725,52000000,25944725,1
108,19945,104356,186,6.3,14000,114977104,25000000,89977104,1
92,6137,25484,189,5.1,13000,54819301,30000000,24819301,1
89,1367,54101,210,5.8,15000,160602194,50000000,110602194,1
93,28767,196422,444,7,0,42931041,12000000,30931041,1
176,1004,144337,309,6.1,0,264218220,175000000,89218220,1
94,24994,281649,458,7.7,21000,8203235,5000000,3203235,1
120,129,217740,1641,7.9,0,213525736,17000000,196525736,1
140,64599,230931,585,7,0,214104620,80000000,134104620,1
158,533,372990,1107,8.1,16000,76181545,25000000,51181545,1
128,2507,132423,349,7.2,15000,60222298,45000000,15222298,1
92,3101,76207,194,6,0,68233629,11000000,57233629,1
100,2968,61321,217,6.2,0,86369815,35000000,51369815,1
178,5074,110394,433,7.7,0,124731534,40000000,84731534,1
132,1873,212204,738,6.6,24000,284139100,250000000,34139100,1
102,2488,104066,207,5.7,15000,68267862,68000000,267862,1
110,2382,40469,135,6.1,0,27640028,20000000,7640028,1
114,214,209396,580,6.8,11000,94679598,25000000,69679598,1
101,32015,321283,1848,7.8,17000,119723856,4000000,115723856,1
110,26451,262153,507,7.8,10000,56308881,27000000,29308881,1
100,4606,190030,583,8,30000,133432856,15000000,118432856,1
99,1066,47364,75,6.5,0,48190704,44000000,4190704,1
110,46646,108843,281,6.1,54000,167221571,7000000,160221571,1
95,3092,62861,232,5.9,0,70067909,19000000,51067909,1
97,19404,260607,485,7.9,47000,9760104,5000000,4760104,1
107,3066,225102,862,7.8,16000,7.1e+07,26000000,4.5e+07,1
96,799,51204,247,4.6,26000,142817992,5000000,137817992,1
121,1446,128010,136,6.7,0,321731527,35000000,286731527,1
101,16926,61360,129,6.6,25000,36606743,20000000,16606743,1
135,2575,143696,241,7.6,0,200512643,30000000,170512643,1
100,15369,91151,283,5.4,20000,89162162,42000000,47162162,1
101,42918,149285,668,7.5,10000,25504513,1800000,23704513,1
104,4082,96233,313,7.4,26000,32935319,11000000,21935319,1
132,1933,172792,1740,6.6,0,97607453,50000000,47607453,1
83,22813,127345,250,6.8,0,155019340,80000000,75019340,1
82,505,297014,1198,7.3,0,261572744,18000000,243572744,1
141,4528,190439,351,7.2,0,378882411,115000000,263882411,1
102,2509,291875,533,8.1,14000,16538431,2777000,13761431,1
94,2725,162909,795,6.2,0,296633907,63000000,233633907,1
108,7273,193770,2003,6.5,0,256697520,60000000,196697520,1
114,428,81444,192,6.2,955,88323487,50000000,38323487,1
110,13396,57266,89,5.7,14000,79700000,40000000,39700000,1
88,4499,84325,205,5.4,0,147934180,35000000,112934180,1
70,63,94225,136,7.4,0,267447150,858000,266589150,1
122,583,22369,100,6.6,21000,85978266,10000000,75978266,1
98,24082,85531,152,5.5,0,310650585,100000000,210650585,1
119,17768,151812,556,6.5,0,250821495,65000000,185821495,1
97,2403,25210,126,5.2,13000,52882018,10000000,42882018,1
127,16034,212085,492,7.7,15000,135560026,70000000,65560026,1
123,88953,141663,383,7,20000,41596251,20000000,21596251,1
118,27674,102248,403,6.1,34000,154984035,70000000,84984035,1
183,34025,232577,1026,8.2,11000,5e+07,15000000,3.5e+07,1
90,2203,160321,178,6.3,0,212385533,30000000,182385533,1
131,5103,188887,662,7.6,0,96976270,70000000,26976270,1
106,24938,211296,428,6.3,0,516642939,80000000,436642939,1
100,2638,85903,92,6,0,287928194,50000000,237928194,1
113,17786,58184,805,4.9,0,91188905,80000000,11188905,1
96,3113,87739,133,6.7,0,81198894,4500000,76698894,1
126,1607,119150,219,7.4,0,43848069,15000000,28848069,1
132,28830,482064,1106,8.1,14000,216763646,30000000,186763646,1
91,3104,18042,73,5.9,0,1.1e+08,55000000,5.5e+07,1
84,1817,140499,358,7,0,224834564,45000000,179834564,1
115,3798,91082,274,7.8,28000,17654912,12000000,5654912,1
89,644,271794,584,8.1,24000,52287000,8000000,44287000,1
107,173,307639,513,8,32000,32002538,15000000,17002538,1
100,39807,270441,378,7.7,40000,39187783,8000000,31187783,1
111,6315,97838,286,7.6,3000,1.5e+08,46000000,1.04e+08,1
107,1747,42614,120,6.8,0,44726644,13000000,31726644,1
101,15230,145395,375,7.3,23000,17693675,6500000,11193675,1
123,17657,223393,550,5.6,24000,219851172,200000000,19851172,1
124,1640,256213,338,7.2,0,95696996,61000000,34696996,1
72,2646,31371,166,5.7,0,35763605,13000000,22763605,1
108,26002,145974,611,6.3,10000,609841637,52000000,557841637,1
108,1715,61018,140,5.8,0,1.13e+08,35000000,7.8e+07,1
110,2169,152089,309,8.1,0,102308889,6000000,96308889,1
134,1050,104005,248,6.2,18000,88058786,35000000,53058786,1
118,3986,283480,263,7.4,0,244527583,40000000,204527583,1
124,7567,189683,559,7.7,0,60427839,20000000,40427839,1
104,1274,87447,371,6.5,0,91974818,43000000,48974818,1
94,2124,140780,376,6.3,0,99965753,24000000,75965753,1
106,1120,102125,324,7,10000,31430334,7000000,24430334,1
147,56014,225122,234,7.8,0,41954997,35000000,6954997,1
126,36017,245333,678,7.5,42000,185770160,170000000,15770160,1
240,1943,171726,256,8.1,12000,77737889,22000000,55737889,1
99,2394,75903,109,6.2,0,153997819,25000000,128997819,1
96,30541,112516,223,6.2,0,34560577,20000000,14560577,1
98,16791,151580,672,6.2,0,129394835,45000000,84394835,1
109,27788,181025,336,7.7,38000,48126384,7000000,41126384,1
81,47677,29738,85,6.2,12000,100654149,28000000,72654149,1
94,2371,76828,314,5.8,24000,205703818,5000000,200703818,1
104,5707,101730,131,6.4,0,49779728,20000000,29779728,1
142,64259,182802,363,6.7,13000,300854823,70000000,230854823,1
115,36237,166693,276,6.8,19000,208076205,85000000,123076205,1
118,13943,173848,203,7.3,25000,85412898,40000000,45412898,1
91,4842,102933,230,6.9,0,100138851,100000000,138851,1
129,2864,71574,244,5.9,951,142400065,75000000,67400065,1
106,15870,129601,648,4.8,0,222104681,170000000,52104681,1
107,3106,90539,379,5.6,0,113916474,45000000,68916474,1
88,21863,243053,488,6.1,0,222231186,85000000,137231186,1
121,3189,142115,614,6.2,0,163876815,10000000,153876815,1
123,7243,79892,619,6.4,0,60474340,40000000,20474340,1
113,15362,53687,152,5.7,1000,95149435,40000000,55149435,1
126,63710,604904,682,8.3,31000,225933435,10000000,215933435,1
124,15229,96096,172,6.4,0,255000211,70000000,185000211,1
141,11458,206776,1248,6.9,0,203388341,68000000,135388341,1
103,1336,75176,252,7.1,26000,165184237,45000000,120184237,1
119,3637,89816,347,6.3,0,96269812,60000000,36269812,1
111,3784,48559,145,6,0,39171130,25000000,14171130,1
100,14611,102129,432,5.5,0,165333180,60000000,105333180,1
92,646,64625,281,7.4,0,49469904,15000000,34469904,1
92,5810,47900,130,6.9,11000,272912430,145000000,127912430,1
96,3569,64794,131,7.3,17000,19560274,6000000,13560274,1
106,2544,86902,411,6.4,0,91753202,40000000,51753202,1
178,24183,333542,533,8.2,11000,116112375,52000000,64112375,1
107,22834,92599,225,7.1,21000,19504039,3500000,16004039,1
145,12098,76842,173,7.2,4000,161001698,14000000,147001698,1
69,1833,61753,133,7.3,5000,84460846,12300000,72160846,1
97,29252,67604,218,7.1,12000,64256513,15000000,49256513,1
94,27911,237848,377,7.8,71000,68263166,16000000,52263166,1
88,10325,185258,404,7.2,0,87055349,24000000,63055349,1
110,5127,170027,350,7.2,13000,181813770,6000000,175813770,1
95,848,64387,85,6.5,15000,248384621,78000000,170384621,1
109,16611,38348,135,6.1,0,44350926,36000000,8350926,1
112,13172,67760,226,7.3,0,39462438,7000000,32462438,1
150,14296,280228,420,7.6,29000,154026136,37000000,117026136,1
98,25780,149947,326,6.8,18000,167805466,100000000,67805466,1
101,15990,81523,214,5.6,0,72108608,70000000,2108608,1
156,20761,97047,452,6.8,0,100230832,55000000,45230832,1
107,4664,247289,611,7.1,0,369884651,23000000,346884651,1
111,15361,54723,99,6.2,0,69821334,8000000,61821334,1
127,19776,113295,235,7.1,0,87784194,60000000,27784194,1
107,12700,246492,685,6.4,7000,237681299,82500000,155181299,1
112,35941,141425,283,7.4,25000,12355734,1000000,11355734,1
113,4660,73068,419,6.8,0,124305181,48000000,76305181,1
109,33878,94892,189,6.8,0,65569869,20000000,45569869,1
104,3356,40654,97,5.3,0,77477008,35000000,42477008,1
94,27842,67296,133,5.8,0,355692760,79000000,276692760,1
81,25489,143251,710,7.7,0,32801173,19000000,13801173,1
118,28045,136680,149,6.4,13000,75450437,52000000,23450437,1
101,4400,157857,1191,7.9,12000,7e+07,300000,69700000,1
107,12556,85629,144,6,14000,111711453,40000000,71711453,1
117,15713,58957,91,6,0,30426096,20000000,10426096,1
105,914,27257,59,5.4,0,347434178,105000000,242434178,1
78,2462,216486,242,6.9,0,107217396,15000000,92217396,1
88,34319,50337,177,3.5,13000,78378744,20000000,58378744,1
178,23950,169023,703,7.1,10000,142940100,90000000,52940100,1
91,22668,41259,72,6.1,0,104945765,70000000,34945765,1
105,42330,357581,588,7.9,16000,5.3e+07,20000000,3.3e+07,1
120,24300,48806,263,7.3,11000,120455994,40000000,80455994,1
102,7009,146899,185,6.4,0,136267476,20000000,116267476,1
132,3152,121937,431,7.6,15000,40270895,22000000,18270895,1
150,27829,70771,671,6.7,0,30536013,30000000,536013,1
99,15369,80305,393,5.7,0,66468332,16000000,50468332,1
91,1125,121084,221,6.2,0,258022233,140000000,118022233,1
105,35694,106755,173,6.6,27000,134402450,28000000,106402450,1
110,4089,80556,184,6.6,0,41627431,20000000,21627431,1
100,19420,34258,178,6.3,0,114281051,30000000,84281051,1
90,794,88714,235,6.3,0,229736344,25000000,204736344,1
100,2389,51996,302,7,0,18564088,16000000,2564088,1
109,1775,74476,184,7.4,15000,95714875,30000000,65714875,1
86,17396,64190,129,5.6,16000,43165571,17000000,26165571,1
98,28027,168314,903,7.3,12000,115505027,27000000,88505027,1
94,32474,109620,268,6.2,15000,68729358,24000000,44729358,1
102,15053,112769,305,6.6,0,65664721,55000000,10664721,1
118,69746,171882,292,7.8,14000,3e+07,11000000,1.9e+07,1
104,3768,110073,194,6.2,0,152930623,75000000,77930623,1
98,1353,150082,384,7.3,36000,97505481,18000000,79505481,1
118,3197,43084,99,6.7,19000,35926213,26000000,9926213,1
95,2787,81334,291,6.5,0,145896422,40000000,105896422,1
227,1076,192775,559,8.4,11000,7e+07,15000000,5.5e+07,1
124,6181,103241,742,7.1,5000,114660784,75000000,39660784,1
123,11769,126307,210,6.8,19000,61808775,30000000,31808775,1
121,4142,264533,609,8.1,12000,3.8e+07,17500000,20500000,1
143,11248,243799,908,7.5,0,135330182,25000000,110330182,1
101,39822,127571,207,6.3,0,152263880,55000000,97263880,1
135,2370,125109,593,6.7,16000,93525586,65000000,28525586,1
95,46120,172754,187,7.3,13000,321885765,130000000,191885765,1
103,2987,63855,248,6.6,0,57469467,11500000,45969467,1
111,27755,152247,189,7.3,0,64822796,20000000,44822796,1
90,24534,106909,268,5.9,0,171963386,42000000,129963386,1
89,24419,58260,286,7.7,0,8679814,500000,8179814,1
92,2348,47169,162,5.9,17000,85446075,14000000,71446075,1
129,318,132048,203,6.4,12000,177259441,40000000,137259441,1
116,600,98535,734,5.5,0,161834276,40000000,121834276,1
112,1171,254404,840,7.8,0,22863596,13000000,9863596,1
137,36258,102728,279,6.6,16000,84606030,35000000,49606030,1
166,13333,459346,822,7.8,23000,333932083,150000000,183932083,1
120,3876,105446,321,7.4,11000,122200000,10700000,111500000,1
139,13021,136367,975,6.7,39000,54674226,32000000,22674226,1
138,17423,182757,483,6.9,19000,194168700,85000000,109168700,1
99,18693,114321,548,6.8,0,114830111,40000000,74830111,1
103,1342,56605,89,7.3,23000,17986781,700000,17286781,1
87,352,143086,211,8.6,0,8500000,1500000,7e+06,1
139,2045,107408,259,7.8,0,102272727,6000000,96272727,1
90,6775,127528,422,6.6,0,151161491,40000000,111161491,1
116,14087,156717,357,6.4,0,177371441,50000000,127371441,1
107,4243,171418,619,6.4,17000,126248813,40000000,86248813,1
94,7014,75152,288,5.8,0,190212113,40000000,150212113,1
138,14619,181879,319,7.6,0,243240178,40000000,203240178,1
97,20645,123553,174,7.3,25000,306941670,145000000,161941670,1
124,17050,83786,231,7.5,0,22222308,20000000,2222308,1
129,28886,318634,1004,7.7,52000,244931766,40000000,204931766,1
128,16751,71754,166,7.2,0,107458785,40000000,67458785,1
107,2848,59248,164,5.6,48000,15008161,12000000,3008161,1
98,2373,23546,92,6.3,819,12348905,2500000,9848905,1
130,13357,213668,270,7.8,0,368875760,40000000,328875760,1
121,1184,145580,351,7.7,0,48027970,6000000,42027970,1
74,5713,162331,332,6.3,0,231449203,55000000,176449203,1
155,3677,189032,560,7.9,0,43101594,15000000,28101594,1
90,34779,83234,475,5.7,30000,10337387,4800000,5537387,1
118,1844,275720,706,8.6,41000,6600000,3180000,3420000,1
89,485,149108,273,7.6,0,92823546,16000000,76823546,1
144,18761,137003,658,6.9,0,117487473,65000000,52487473,1
135,1439,77029,466,5.4,0,74208267,60000000,14208267,1
91,13654,163130,1264,5,6000,163403799,60000000,103403799,1
94,1289,301149,509,7.7,78000,151119219,30000000,121119219,1
130,28018,153468,204,7.3,0,151668774,18000000,133668774,1
82,303717,75345,290,5.2,0,186167139,40000000,146167139,1
172,1785,165638,301,8.3,8000,5e+06,4000000,1e+06,1
133,26388,112175,329,7.5,11000,160638883,30000000,130638883,1
101,2609,93272,251,6.5,0,54956140,20000000,34956140,1
105,3464,126464,175,7.3,0,316360478,15000000,301360478,1
105,3697,99043,643,5.8,0,73648228,60000000,13648228,1
87,4073,22838,56,4.4,0,342695435,75000000,267695435,1
115,2466,76303,376,5.6,0,33333531,30000000,3333531,1
98,17582,90374,318,6.7,0,106371651,41300000,65071651,1
129,36069,89424,224,7.2,0,48814909,32000000,16814909,1
158,144,55889,390,6.4,0,66976317,60000000,6976317,1
85,3112,117212,367,7.2,0,145771527,80000000,65771527,1
115,31523,142440,505,6.3,3000,195735876,70000000,125735876,1
125,45696,95437,211,5.7,9000,216485654,52000000,164485654,1
97,6223,149222,749,6.9,0,75902208,10500000,65402208,1
120,705,179235,2814,7.1,13000,611899420,30000000,581899420,1
105,1006,59805,95,6.4,0,51164106,26000000,25164106,1
102,46186,130094,471,6.4,0,98185582,29000000,69185582,1
121,2027,60573,248,3.7,894,164508066,160000000,4508066,1
91,6576,105902,206,6.2,0,287594577,150000000,137594577,1
89,3462,200293,621,7.8,16000,12827813,10000000,2827813,1
90,34565,201084,523,6.6,0,60780981,28000000,32780981,1
133,12874,298590,559,7,0,219076518,30000000,189076518,1
102,14552,85833,113,6.7,17000,268426634,100000000,168426634,1
95,10040,105591,178,7.1,10000,6854611,2500000,4354611,1
101,4298,54421,101,5.8,3000,84601681,40000000,44601681,1
109,328,95362,270,7.9,62000,11176469,3000000,8176469,1
101,7227,355810,889,7.9,15000,100523181,8000000,92523181,1
85,2496,80193,333,8.1,3000,8e+06,750000,7250000,1
85,332,90827,329,7.9,26000,20710513,160000,20550513,1
110,939,96690,293,6.6,0,56932305,55000000,1932305,1
119,53895,152591,414,7.3,0,75225693,35000000,40225693,1
129,15595,81298,341,6.9,39000,55247881,40000000,15247881,1
99,25942,155532,543,6.5,0,147080413,102000000,45080413,1
145,2380,119286,548,7.3,0,162242962,85000000,77242962,1
112,1372,89906,175,8,13000,19777647,14000000,5777647,1
120,1573,77392,245,8.2,0,9600000,1900000,7700000,1
129,2551,89972,126,6.1,0,411006740,25000000,386006740,1
129,14344,80140,323,6.5,16000,105197635,50000000,55197635,1
128,3888,36587,95,6,0,214015089,55000000,159015089,1
87,760,62038,281,6.5,0,44196684,9000000,35196684,1
91,2954,84209,201,5.2,0,183293131,26000000,157293131,1
101,2636,85673,269,6.1,0,93354918,60000000,33354918,1
124,3424,49536,379,5.9,0,215663859,75000000,140663859,1
123,43917,87351,344,6.1,2000,147845033,57000000,90845033,1
110,847,68417,195,5.6,0,130431368,54000000,76431368,1
107,17627,106111,181,7,49000,59389433,15000000,44389433,1
108,2178,94456,576,5.3,0,68766121,40000000,28766121,1
153,1383,188637,815,7.9,11000,186438883,28000000,158438883,1
98,2287,126746,600,6.2,0,223387299,55000000,168387299,1
103,4662,54242,145,6.6,14000,41296320,19800000,21496320,1
124,36873,111003,199,7.1,22000,120081841,50000000,70081841,1
106,11454,70838,208,5.6,18000,183018522,85000000,98018522,1
98,3617,71183,183,7.4,0,61399552,15000000,46399552,1
94,6017,86347,191,7.1,0,139804348,53000000,86804348,1
95,2020,57479,205,5.4,0,101564935,18000000,83564935,1
113,36009,46480,115,6.4,12000,44907260,40000000,4907260,1
101,1852,76882,106,6.5,29000,99357138,25000000,74357138,1
102,2103,181749,615,7.8,0,3151130,27000,3124130,1
109,3148,65979,220,6.3,999,35294470,30000000,5294470,1
121,1531,60508,285,6.7,4000,89456761,65000000,24456761,1
134,3007,33570,259,3.6,1000,19300000,17000000,2300000,1
110,44798,168172,380,6.5,0,230685453,80000000,150685453,1
116,14931,65297,602,6.6,0,127666415,62000000,65666415,1
111,4486,104119,518,6.2,26000,97138686,40000000,57138686,1
194,19600,217373,942,7.2,0,211643158,130000000,81643158,1
102,60646,88451,289,7.1,0,119000410,75000000,44000410,1
102,5392,44662,127,5.2,0,169852759,80000000,89852759,1
136,2997,140527,447,8,13000,33395426,3200000,30195426,1
118,28479,90046,141,6.2,17000,46216641,35000000,11216641,1
111,13645,94049,301,6.2,0,165335153,37000000,128335153,1
113,3141,143137,602,7.6,10000,47126295,30000000,17126295,1
106,4830,15310,38,5.7,3000,70181428,24000000,46181428,1
98,3345,181058,674,6.7,0,53302314,23000000,30302314,1
96,19894,198111,365,7.2,14000,96408652,15000000,81408652,1
101,3400,195255,170,6.9,0,92380927,28000000,64380927,1
103,16249,107772,398,5.4,0,85416905,35000000,50416905,1
114,2842,109445,426,5.9,0,141069860,40000000,101069860,1
175,669,40277,210,7.4,0,50750000,22000000,28750000,1
139,848,236000,1043,7.8,14000,120175290,40000000,80175290,1
87,4774,73886,165,7,25000,81491068,39000000,42491068,1
94,3889,132963,302,6.5,0,119754278,16000000,103754278,1
129,2024,113065,337,6.9,0,68851475,20000000,48851475,1
102,1655,187595,978,7.6,0,26781723,2500000,24281723,1
113,813,172080,1017,7.2,0,306776732,45000000,261776732,1
103,33565,72673,166,6.3,0,40452643,25000000,15452643,1
125,19809,117719,306,7.5,39000,112544580,35000000,77544580,1
115,9082,57040,365,6.1,0,91036760,25000000,66036760,1
146,20454,266310,690,7.7,14000,130293714,70000000,60293714,1
122,19764,132954,514,5.9,0,128905366,65000000,63905366,1
134,39789,259837,2254,7.7,13000,178043761,14000000,164043761,1
127,3100,154199,252,7,0,5.05e+08,22000000,4.83e+08,1
122,31958,146352,288,5.8,42000,371876278,130000000,241876278,1
98,2376,76094,233,7.6,37000,100129872,12000000,88129872,1
120,13581,293662,836,7.6,0,217764291,65000000,152764291,1
138,17524,53251,188,6.3,0,10629321,8000000,2629321,1
98,22318,89557,376,5.8,0,141591324,40000000,101591324,1
113,23456,66579,134,5.7,20000,142044638,56000000,86044638,1
101,1292,77987,120,6.1,0,49830607,19000000,30830607,1
87,1417,97089,233,5.7,20000,78309131,60000000,18309131,1
93,2872,45317,536,5.6,0,40846082,19000000,21846082,1
107,14483,75347,176,5.6,0,55583804,30000000,25583804,1
138,1942,338415,935,8,12000,156822020,25000000,131822020,1
149,31349,99558,236,7.4,0,152266007,40000000,112266007,1
93,42002,30765,252,4.9,963,34872033,11000000,23872033,1
86,3423,16580,55,5.4,916,57881056,45000000,12881056,1
117,15371,158267,559,6.7,0,155010032,54000000,101010032,1
106,12418,55539,147,7,20000,28883511,10000000,18883511,1
121,39690,67797,285,7.3,30000,74188937,25000000,49188937,1
124,38227,88225,227,6.3,0,159330280,60000000,99330280,1
97,14025,111625,369,6.2,20000,37930465,15000000,22930465,1
107,31529,46961,132,6.2,0,69055695,32000000,37055695,1
123,3768,71708,307,7,0,77745568,48000000,29745568,1
118,15658,218771,651,7.2,0,113714830,46000000,67714830,1
101,5056,92640,212,7,23000,24261569,20000000,4261569,1
202,20143,63923,156,7.7,0,48169908,34000000,14169908,1
87,3287,33884,79,4.6,266,176104344,70000000,106104344,1
100,12258,76770,203,4.9,0,62357900,60000000,2357900,1
106,8315,102167,483,5.8,0,204999686,52000000,152999686,1
102,23352,22449,191,4.8,387,30114487,25000000,5114487,1
113,24106,149019,666,6.1,0,350983908,180000000,170983908,1
99,19334,31968,82,4.6,663,138259062,40000000,98259062,1
94,3436,29971,71,5.4,0,45236543,28000000,17236543,1
101,23328,70205,450,5.9,0,122644820,25000000,97644820,1
96,17416,62424,90,6.5,13000,282570682,135000000,147570682,1
104,33903,99236,321,7.5,0,50907234,20000000,30907234,1
95,2173,49888,220,5,25000,52302796,20000000,32302796,1
94,2812,88241,266,6.7,23000,68572378,13000000,55572378,1
100,34446,111658,297,7.2,20000,13831503,2000000,11831503,1
94,2820,67191,108,6,14000,187361754,55000000,132361754,1
100,4094,71276,181,6.4,13000,29922472,19000000,10922472,1
99,450,36108,260,5.7,0,72500000,7000000,65500000,1
159,11424,227071,1500,7.3,10000,162091208,65000000,97091208,1
134,4453,95241,439,7.8,11000,56505065,25000000,31505065,1
118,5637,150764,318,6.6,0,177995103,80000000,97995103,1
112,18141,206104,850,6.8,0,196397415,48000000,148397415,1
125,16646,85844,322,6.7,0,75764085,60000000,15764085,1
130,2407,106528,257,6.2,0,137298489,85000000,52298489,1
116,31224,58450,842,6.4,0,67312826,60000000,7312826,1
98,656730,267921,577,7.2,0,90574188,26000000,64574188,1
113,1302,88132,274,6.2,0,212404396,66000000,146404396,1
94,4868,36666,144,5.3,0,62646763,18000000,44646763,1
68,10557,183425,425,7,0,67683989,16500000,51183989,1
98,20060,294163,718,8.1,33000,30857814,16000000,14857814,1
123,1690,175524,752,7.2,0,289317794,25000000,264317794,1
93,22745,84070,526,7.5,0,54600000,7000000,47600000,1
127,1557,70382,190,7.9,33000,19839492,8900000,10939492,1
130,16693,181737,1015,7.4,10000,30652890,10000000,20652890,1
114,4537,71842,152,7.1,0,79567667,12000000,67567667,1
99,50284,105585,419,5.6,0,125586134,17000000,108586134,1
135,8355,76099,162,6.7,0,136982834,75000000,61982834,1
96,12754,186606,1125,7.5,0,60740827,32000000,28740827,1
101,39269,107817,255,5.4,14000,246984278,80000000,166984278,1
81,2268,8860,45,4.5,279,63800345,37000000,26800345,1
99,23755,80617,190,6.5,36000,27462041,15000000,12462041,1
98,7039,52805,209,5.2,0,87840042,40000000,47840042,1
136,36925,67856,345,6.7,0,108103450,100000000,8103450,1
113,15914,30213,112,6.8,0,110879513,19000000,91879513,1
119,29484,70292,274,6.7,8000,65754228,40000000,25754228,1
84,3382,94172,179,5.9,0,300135367,133000000,167135367,1
138,19129,414219,625,8.3,11000,126216940,35000000,91216940,1
135,1591,139288,339,7.7,0,303788635,20000000,283788635,1
113,26239,144053,395,6.3,0,494471524,92000000,402471524,1
122,22574,57210,158,6.8,13000,31554855,15000000,16554855,1
94,4530,68406,162,5.4,0,129832389,60000000,69832389,1
104,4487,108076,1690,5.1,0,249288105,100000000,149288105,1
119,3525,22304,33,6.2,894,44352417,27000000,17352417,1
121,3903,89509,524,5.7,2000,211989043,100000000,111989043,1
110,5187,101386,289,7.1,0,86658558,70000000,16658558,1
106,30,6920,22,6.7,0,2.4e+07,22000000,2e+06,1
106,18712,20810,100,7.1,0,10835752,10000000,835752,1
101,2436,162701,962,7.4,19000,41227069,11000000,30227069,1
135,27237,54631,192,7.5,0,182016617,24000000,158016617,1
108,1569,62271,277,5.8,0,178127760,116000000,62127760,1
88,1584,49820,311,6.6,0,44793222,5000000,39793222,1
121,19139,39529,142,6.7,1000,50068310,50000000,68310,1
120,36062,95367,260,6.9,33000,114156230,38000000,76156230,1
120,33615,148490,537,7.4,0,50315140,48000000,2315140,1
105,42473,88035,201,7.1,10000,43318349,26000000,17318349,1
92,488,97775,211,6.5,0,52615806,52000000,615806,1
130,2684,133076,779,6.4,0,325756637,120000000,205756637,1
116,845,102895,159,7.5,0,90400000,40600000,49800000,1
95,47203,181225,784,6.6,0,310940086,33000000,277940086,1
139,15111,162130,962,7.2,0,155721132,24000000,131721132,1
95,1414,82082,236,6.1,10000,32204030,20000000,12204030,1
101,57077,188652,288,7.1,22000,75993061,12500000,63493061,1
94,41059,79146,352,4.3,25000,32438988,6000000,26438988,1
93,12691,192940,491,8.1,0,38251425,4000000,34251425,1
118,563,77551,434,7.6,0,11540607,2000000,9540607,1
112,15800,64747,122,6.5,12000,42930462,35000000,7930462,1
100,647,143121,279,7.7,10000,124596398,60000000,64596398,1
155,38518,145257,322,6.9,0,390493908,48000000,342493908,1
102,26998,123558,609,7.3,19000,90683916,45000000,45683916,1
97,4692,89101,885,5.8,3000,114908830,30000000,84908830,1
115,3454,84424,131,6.1,0,242295562,100000000,142295562,1
88,5706,52069,95,5.6,0,62616646,30000000,32616646,1
99,3696,96607,125,6.8,5000,191502426,30000000,161502426,1
128,904,68119,230,7.6,0,73276047,20000000,53276047,1
114,12624,102123,660,7.6,0,108846072,25000000,83846072,1
121,2747,57958,345,7,0,65705772,26000000,39705772,1
93,26760,161858,289,6.4,0,234801895,34200000,200601895,1
113,8172,83506,144,5.5,0,171844840,70000000,101844840,1
93,13748,49739,407,5.2,0,1.02e+08,90000000,1.2e+07,1
106,2053,142293,245,7.2,14000,153083102,11000000,142083102,1
117,2144,113068,382,7.8,0,75505856,40000000,35505856,1
107,1095,58297,161,6.6,0,42886719,30000000,12886719,1
103,2481,62009,109,5.8,2000,31042035,18000000,13042035,1
97,2990,114797,472,7.4,0,26888376,5000000,21888376,1
120,527,175196,350,8.3,10000,2.5e+07,3500000,21500000,1
105,36,183288,395,8.1,22000,5535405,2500000,3035405,1
90,15710,74875,115,6.4,11000,17273593,10000000,7273593,1
122,903,73193,190,7.6,0,39363635,11000000,28363635,1
122,32930,101888,365,7.9,0,26828365,18000000,8828365,1
128,16911,66511,200,7.5,28000,95020213,40000000,55020213,1
86,673,76407,335,7,0,14564027,1000000,13564027,1
128,13189,136673,281,7.6,10000,54586584,20000000,34586584,1
105,1454,79461,463,6.3,10000,65464324,20000000,45464324,1
101,6867,34942,185,5.8,1000,56489558,25000000,31489558,1
100,4198,112138,237,7.3,12000,26096852,7500000,18596852,1
120,40117,69576,207,6.9,2000,44862187,15000000,29862187,1
99,26527,58416,301,5.9,0,107196498,46000000,61196498,1
103,6207,56741,515,6.4,1000,1.18e+08,70000000,4.8e+07,1
97,3261,39541,334,5.3,3000,37597471,20000000,17597471,1
88,5737,72552,374,5.5,13000,83188165,24000000,59188165,1
110,13331,50148,116,5.4,0,170362582,45000000,125362582,1
110,4146,141414,482,6,0,345141403,123000000,222141403,1
110,3757,39357,113,6.8,14000,28831145,27000000,1831145,1
114,2091,147317,197,6.4,12000,90029656,40000000,50029656,1
124,6393,35833,96,7,10000,38307627,25000000,13307627,1
89,1980,52509,84,7.1,13000,3325038,2500000,825038,1
121,14890,121676,290,7.4,0,22921898,12000000,10921898,1
122,5165,34579,62,6.6,0,96070507,12000000,84070507,1
117,12757,81442,137,6.9,0,178051587,45000000,133051587,1
137,5746,38658,284,5,930,39143839,20000000,19143839,1
112,3185,86205,232,6.2,5000,72436439,35000000,37436439,1
92,1303,71387,228,7,21000,1776935,100000,1676935,1
206,698,113472,442,8,0,205405498,40000000,165405498,1
120,54877,160776,402,7.8,0,136706683,30000000,106706683,1
88,137712,26236,110,5.7,0,22942221,20000000,2942221,1
95,1186,32378,150,6.1,0,18999718,3000000,15999718,1
146,20516,76016,265,7.6,0,73956241,50000000,23956241,1
132,2466,284252,1058,8,18000,441306145,8000000,433306145,1
111,313,83374,828,7.6,0,76286096,15000000,61286096,1
112,14954,63839,238,7.5,0,1.15e+08,777000,114223000,1
119,6089,24285,110,6.4,10000,80383113,50000000,30383113,1
89,584,29659,227,5.1,1000,22168359,8000000,14168359,1
83,6081,65270,100,6.2,863,197309027,85000000,112309027,1
104,1093,60293,114,5.5,669,119208989,50000000,69208989,1
108,18656,227824,273,6.7,10000,317375031,40000000,277375031,1
94,486,85333,421,7.3,0,123384128,15000000,108384128,1
117,14486,119807,340,6,0,116643346,80000000,36643346,1
72,3402,13324,79,5.8,302,109862682,20000000,89862682,1
101,1738,87677,388,6.8,11000,100086793,100000000,86793,1
88,53370,31191,120,5.4,0,92219310,35000000,57219310,1
100,4121,84824,95,6.4,0,299965036,20000000,279965036,1
100,25387,32103,112,5.7,0,68896829,28000000,40896829,1
113,3341,40362,248,6.3,970,100020092,50000000,50020092,1
117,1862,107923,197,7.1,0,254700832,6000000,248700832,1
121,24248,60115,224,7.2,0,29541790,23000000,6541790,1
106,11264,212499,277,6.9,0,128107642,65000000,63107642,1
98,1081,82133,359,5.7,14000,177512032,3000000,174512032,1
92,18765,44130,156,5.4,0,56309766,12000000,44309766,1
112,3432,76498,203,6.4,15000,60965854,40000000,20965854,1
97,3984,96693,271,6.1,0,110230332,26000000,84230332,1
105,1442,34098,214,7.2,1000,12633747,6500000,6133747,1
118,29748,120202,397,6.7,0,151493655,73000000,78493655,1
106,19906,149998,285,6.4,0,150166126,100000000,50166126,1
83,11771,28513,126,5.2,0,64110728,3300000,60810728,1
101,2822,74622,150,5.6,0,59192128,25000000,34192128,1
89,5470,16437,68,4.9,0,30551495,24000000,6551495,1
90,3148,111368,394,7.1,0,161626121,90000000,71626121,1
89,843,49312,211,4.9,0,64626786,30000000,34626786,1
112,13707,71495,522,7.1,0,44909486,4000000,40909486,1
112,16196,193962,805,7.1,5000,53187659,23000000,30187659,1
98,10938,164608,383,6.4,10000,77566815,30000000,47566815,1
112,1205,67893,163,6.3,18000,73244881,17000000,56244881,1
107,3004,28573,87,5.7,5000,1.8e+07,13000000,5e+06,1
154,2592,60988,199,7.8,6000,146292009,15000000,131292009,1
99,5642,158354,691,6.6,11000,90842646,30000000,60842646,1
106,2703,112671,315,8,14000,86273333,2800000,83473333,1
110,22140,100571,416,7.4,0,49084830,7000000,42084830,1
97,20312,27689,74,6.5,1000,17500000,10000000,7500000,1
113,814,138435,527,6.6,0,75505973,30000000,45505973,1
100,1949,134869,304,6.2,57000,146497771,15000000,131497771,1
96,36093,248468,545,7,0,163720069,37000000,126720069,1
103,1212,222018,869,7.2,11000,173046663,14000000,159046663,1
96,4380,131801,548,6.2,0,141774679,18000000,123774679,1
101,38809,73368,248,6,0,73174566,60000000,13174566,1
125,2329,49934,224,4.9,0,75800000,39000000,36800000,1
95,2558,24089,82,5.5,0,183953723,63000000,120953723,1
103,3150,29523,121,4.7,0,85280250,58000000,27280250,1
124,9255,203269,602,7,11000,363889678,42000000,321889678,1
129,1565,111351,568,7.5,0,82466670,25000000,57466670,1
98,15251,63108,330,5.9,15000,42333295,10000000,32333295,1
109,2474,79877,677,6.3,0,104155843,33000000,71155843,1
82,3326,10233,63,4.3,0,112483764,85000000,27483764,1
122,12410,130776,437,6.6,0,162966177,72500000,90466177,1
117,3681,72693,199,6.9,0,54926886,21000000,33926886,1
102,2961,50523,113,6.3,0,42045846,32000000,10045846,1
111,3393,103230,143,5.9,10000,83160734,36000000,47160734,1
136,12226,96385,119,7,0,131457682,70000000,61457682,1
136,20299,92702,209,7.2,0,76669806,30000000,46669806,1
120,5826,97664,232,5.7,17000,173965010,35000000,138965010,1
107,18983,131180,220,6.8,0,17164377,9500000,7664377,1
139,12182,189923,318,7.3,0,273552592,50000000,223552592,1
103,3004,54390,398,6.2,0,50041732,29000000,21041732,1
114,12499,121259,361,7,0,143049560,92000000,51049560,1
110,146,57996,349,6.5,15000,81272766,12000000,69272766,1
96,1432,22764,91,5.5,511,8844595,1700000,7144595,1
120,15226,69860,214,6.6,0,219103655,85000000,134103655,1
118,15889,59435,323,5.7,0,95226116,53000000,42226116,1
86,2420,102861,571,5.8,0,117719158,25000000,92719158,1
102,51355,59637,130,7.1,21000,13231461,6000000,7231461,1
128,22679,91092,402,6.7,0,266728738,80000000,186728738,1
115,4496,48753,323,6.5,0,74541707,60000000,14541707,1
114,19904,75864,197,6,23000,96047633,37000000,59047633,1
119,1651,63677,460,6.5,0,55157539,32000000,23157539,1
219,2451,70274,133,7.8,0,43984230,23000000,20984230,1
104,33758,138707,202,7.2,0,25405445,7000000,18405445,1
101,661,89568,142,6.3,17000,160078586,45000000,115078586,1
116,33233,40126,107,6.6,975,100860818,46000000,54860818,1
96,3718,122347,345,6,0,102825796,47000000,55825796,1
116,20258,92237,366,7.2,25000,24145613,20000000,4145613,1
91,1083,75920,474,5.5,0,68349884,35000000,33349884,1
121,5987,103493,317,8.1,17000,23689877,3800000,19889877,1
116,771,30982,199,7.5,0,12600000,3500000,9100000,1
119,1639,55101,201,6.9,3000,320145693,14000000,306145693,1
85,25590,54077,112,6.8,0,149044513,85000000,64044513,1
99,5074,84620,235,6.8,27000,12077441,12000000,77441,1
131,19815,28942,223,6.1,0,118880016,80000000,38880016,1
154,61110,118483,674,7.2,0,173013509,79000000,94013509,1
104,1662,50125,140,5.7,0,58853106,4500000,54353106,1
104,1165,26066,216,5.6,0,51842679,25000000,26842679,1
105,14762,58743,192,6.6,0,8.7e+07,18000000,6.9e+07,1
125,1556,107557,612,7.2,0,105834556,30000000,75834556,1
125,15850,143525,657,7.1,0,96889998,72000000,24889998,1
98,5270,70141,385,5.9,0,90449929,28000000,62449929,1
124,2583,63067,533,6.7,0,119137784,50000000,69137784,1
103,2013,44804,182,7.2,0,20766616,10000000,10766616,1
129,14421,67395,564,6,0,162945894,63000000,99945894,1
104,1827,36223,208,6.2,0,50451307,30000000,20451307,1
88,941,23268,95,6.1,794,9700000,1800000,7900000,1
108,12178,24150,118,6.7,923,18928871,16000000,2928871,1
95,11946,139749,509,6.4,29000,127730736,17000000,110730736,1
104,7247,88049,279,6.6,0,127906624,55000000,72906624,1
108,70996,132501,548,6.5,0,384335608,100000000,284335608,1
134,17159,183909,666,6.7,0,115772733,105000000,10772733,1
83,1987,77935,122,6.1,0,40547440,28000000,12547440,1
133,2916,40858,144,6.4,0,121969216,55000000,66969216,1
91,758,57281,350,6.5,0,94935764,45000000,49935764,1
146,4555,59581,293,4.3,0,288347692,100000000,188347692,1
115,34606,43574,302,6.1,0,56714147,50000000,6714147,1
105,20109,116762,261,6.4,0,33889159,20000000,13889159,1
113,15765,114070,500,7.3,0,12021272,250000,11771272,1
94,3451,13661,134,5.3,487,20627372,16000000,4627372,1
152,1802,71919,316,7.6,0,43656822,6000000,37656822,1
127,5838,158864,395,6.4,0,374111707,70000000,304111707,1
86,2714,101287,260,7,31000,4007792,750000,3257792,1
123,25661,191470,278,6.8,0,69823199,35000000,34823199,1
107,3435,49007,97,7.2,0,49797148,11000000,38797148,1
116,14701,77366,194,7.4,0,177200000,21000000,156200000,1
130,12890,98403,683,6.6,0,155464351,100000000,55464351,1
154,14244,88844,142,6.8,0,270248367,42000000,228248367,1
108,8610,77415,139,6.1,0,54682547,40000000,14682547,1
125,1748,39306,119,6.6,0,45892212,30000000,15892212,1
112,13827,59352,138,5.6,0,111231041,70000000,41231041,1
101,3816,81783,283,5.8,0,122195920,18000000,104195920,1
119,3284,133367,363,7.3,0,92991835,25000000,67991835,1
95,28734,67115,389,5.8,0,103166989,10000000,93166989,1
102,3592,54346,358,6.2,0,36098382,35000000,1098382,1
126,2004,126907,235,7.2,0,90815558,8000000,82815558,1
75,3192,111649,437,6.7,0,57500000,10000000,47500000,1
81,276,13521,150,4.2,0,42664410,100000,42564410,1
100,7048,71202,380,4.8,0,56681566,43000000,13681566,1
101,2373,112669,226,6.6,0,38122105,27000000,11122105,1
105,3439,62986,150,6.9,0,115101622,30250000,84851622,1
90,3172,120786,472,6.2,0,90426405,26000000,64426405,1
99,3500,47814,426,5.5,0,72527595,14000000,58527595,1
130,12186,58402,370,5.1,0,136159423,80000000,56159423,1
100,25206,72867,120,5.4,0,98159963,75000000,23159963,1
136,1579,84118,245,6.3,13000,134748021,70000000,64748021,1
143,28176,131227,346,6.3,41000,173649015,50000000,123649015,1
99,2010,44394,115,5.8,0,101646581,27000000,74646581,1
81,2252,63912,251,5.8,912,314432665,150000000,164432665,1
115,15571,30077,175,6.3,893,63781810,42000000,21781810,1
134,12749,45703,156,7.9,0,23237911,11500000,11737911,1
112,17568,87090,142,7.6,0,4.3e+07,8000000,3.5e+07,1
109,1582,251349,547,7.9,10000,44703995,6000000,38703995,1
105,12894,82327,350,6.4,18000,114956699,13000000,101956699,1
106,3598,34774,162,6.8,1000,21284514,20000000,1284514,1
108,3892,47003,215,5.9,11000,108609310,30000000,78609310,1
120,2321,124941,488,6.1,0,172363301,24000000,148363301,1
86,6355,71424,521,4.9,0,275650703,84000000,191650703,1
110,15170,44021,83,6.2,0,147880543,22000000,125880543,1
126,2282,56665,469,7.6,0,16942795,16500000,442795,1
125,15811,33067,134,6.9,0,41480851,30000000,11480851,1
72,4480,11634,58,5.4,227,135680000,20000000,115680000,1
92,6327,12399,84,3.8,0,39340177,35000000,4340177,1
116,16539,91414,359,7.7,0,96800000,12000000,84800000,1
96,41293,147504,531,6.6,0,92913171,40000000,52913171,1
87,1679,34948,118,5.1,0,51680201,35000000,16680201,1
100,1395,76560,322,6.3,0,119940815,60000000,59940815,1
114,12097,57363,308,7.2,10000,25697647,10000000,15697647,1
104,11632,128593,867,6.9,0,33788161,22000000,11788161,1
125,529,64556,140,8.1,0,38535221,12806000,25729221,1
77,2682,36471,69,5.4,459,169956806,120000000,49956806,1
90,2486,10986,84,5.3,0,39300000,20000000,19300000,1
91,1185,94435,182,6.8,5000,254134910,30000000,224134910,1
94,156,132386,398,7.8,38000,20416563,12500000,7916563,1
118,4045,81866,510,7.3,0,68106245,31000000,37106245,1
115,14322,50653,143,6.6,0,60527873,27000000,33527873,1
103,3211,44103,149,5.3,0,38159905,28000000,10159905,1
121,14165,183247,440,7.1,0,200276000,75000000,125276000,1
92,1045,27486,284,4.7,0,22165608,20000000,2165608,1
87,4171,46031,235,5.2,0,93375151,60000000,33375151,1
105,2689,33887,160,5.9,919,68915888,35000000,33915888,1
126,5371,220475,1066,7.2,20000,57096190,18000000,39096190,1
118,7654,80196,190,6.5,0,60161391,50000000,10161391,1
122,943,24557,111,6.5,13000,64076736,3860000,60216736,1
92,13162,156143,289,7,0,41205099,12000000,29205099,1
86,3421,34620,107,5.1,0,60141683,2500000,57641683,1
89,11192,33335,128,7.3,0,18344729,2000000,16344729,1
95,1070,30394,103,5.8,0,41863726,40000000,1863726,1
94,20348,42737,128,5.4,781,129181830,60000000,69181830,1
105,2604,115649,1033,5.6,4000,62022014,33000000,29022014,1
97,2790,64742,111,6.4,0,189833357,22000000,167833357,1
215,1937,138941,1448,7.6,0,98126565,52000000,46126565,1
104,1196,82476,280,7.8,0,41158757,1800000,39358757,1
92,3074,83788,227,5.9,20000,157887643,47000000,110887643,1
113,13693,130070,316,6.4,0,190320568,82000000,108320568,1
105,101383,50170,306,5.8,773,82800000,45000000,37800000,1
117,3611,70698,196,6.9,9000,42064105,35000000,7064105,1
119,4315,61680,222,6.4,19000,89519773,55000000,34519773,1
134,24458,124222,259,7.4,23000,122233971,60000000,62233971,1
128,3869,61114,212,7.5,22000,66787908,20000000,46787908,1
90,1566,19622,58,6,931,4630045,4000000,630045,1
99,1462,52805,278,6.8,0,5.8e+07,6000000,5.2e+07,1
122,1448,113152,1416,7.5,0,119114517,6000000,113114517,1
120,17336,41313,246,7,0,28780255,26000000,2780255,1
96,20132,66840,248,6.7,0,31584901,4000000,27584901,1
97,14868,184795,310,7.4,22000,175372502,45000000,130372502,1
103,22383,85198,303,7,0,50871113,45000000,5871113,1
109,3668,41138,208,7.4,2000,7011317,4500000,2511317,1
122,41636,124765,541,6.8,0,74558115,35000000,39558115,1
136,41059,78392,196,7.7,0,1.35e+08,16500000,118500000,1
110,874,28736,72,5.5,0,30102717,15000000,15102717,1
94,1118,75669,451,6.4,19000,4242978,500000,3742978,1
123,5975,63839,118,6.4,0,152036382,32000000,120036382,1
102,362,125198,153,6.6,11000,46221189,42000000,4221189,1
106,18645,110616,291,7.1,16000,34705850,4000000,30705850,1
98,3939,27492,84,6.1,0,59827328,11000000,48827328,1
94,683,25843,64,6,941,107944236,86000000,21944236,1
186,3847,44457,176,8.3,0,1e+07,3000000,7e+06,1
89,3717,73539,271,4.6,0,136885767,45000000,91885767,1
98,2110,18481,230,5.9,4000,35841901,20000000,15841901,1
128,24006,127503,261,7.3,0,182300000,35000000,147300000,1
109,1574,137377,370,6.2,0,2.12e+08,45000000,1.67e+08,1
101,4286,65785,160,7,16000,140073390,80000000,60073390,1
97,23242,53415,339,6.6,0,36642838,23000000,13642838,1
141,751,132149,316,7.9,5000,68673228,19000000,49673228,1
96,929,67654,504,7.5,0,46243000,1000000,45243000,1
99,12619,72324,134,7.4,3000,145793296,7500000,138293296,1
124,12556,86504,568,6.4,0,193921372,68000000,125921372,1
121,6910,27675,181,5.8,0,16757163,13000000,3757163,1
95,37967,58412,242,5.6,2000,88715192,50000000,38715192,1
109,11736,105568,533,7.3,0,60378584,8000000,52378584,1
108,4251,83786,392,6.1,0,180622424,30000000,150622424,1
114,25126,53132,101,5.8,0,159212469,80000000,79212469,1
87,3850,60202,114,5.7,0,34942188,25000000,9942188,1
147,37076,154487,259,7.5,0,165615285,44000000,121615285,1
112,2371,48019,153,5.9,13000,59901913,35000000,24901913,1
128,2100,86152,411,6.4,0,162944923,80000000,82944923,1
129,3833,215086,471,8.4,15000,13129846,2000000,11129846,1
91,1921,15664,149,5.8,0,45300000,13000000,32300000,1
116,475,52136,184,6.2,0,118063304,68000000,50063304,1
108,4403,210680,479,7.1,0,131282949,35000000,96282949,1
115,525,12596,64,6.7,0,30127963,15000000,15127963,1
99,17204,71679,216,7,17000,35057696,6400000,28657696,1
91,52566,32157,119,5.3,913,69307224,35000000,34307224,1
118,22517,217480,429,7.4,21000,126690726,53000000,73690726,1
119,11895,57831,115,7,0,52293982,13800000,38493982,1
114,13905,94407,322,6.7,0,198685114,55000000,143685114,1
105,28928,166194,215,7.1,0,91636986,41000000,50636986,1
96,1825,62364,337,5.9,0,84146832,20000000,64146832,1
101,58823,174591,632,7.8,0,116766556,25000000,91766556,1
90,1982,86890,985,6.1,0,59217789,10000000,49217789,1
110,35345,54710,177,6.3,0,19179969,17500000,1679969,1
90,13823,119450,300,6.1,0,185991646,23000000,162991646,1
106,13634,180479,411,6.6,42000,135458097,60000000,75458097,1
195,2291,16255,127,7.5,0,40382659,32000000,8382659,1
115,3770,30667,234,5.6,0,51801187,38000000,13801187,1
97,14432,75365,149,6.3,0,63408614,55000000,8408614,1
93,2319,10082,100,5.9,0,3500000,2700000,8e+05,1
114,3743,137854,560,7.1,3000,1.08e+08,75000000,3.3e+07,1
107,1614,68935,125,6.6,0,162839667,90000000,72839667,1
95,1495,102071,756,6.6,5000,368744044,5000000,363744044,1
99,23344,27378,365,4.9,0,33000337,28000000,5000337,1
100,2654,35965,144,4.9,11000,100525432,20000000,80525432,1
111,257,159198,438,6.8,38000,63782078,30000000,33782078,1
112,3507,43795,171,4.5,0,90,11,79,1
139,36810,137891,696,7.3,0,128798265,40000000,88798265,1
109,3544,19505,162,5.2,0,75511123,13000000,62511123,1
97,18789,63969,126,5.5,0,70442940,25000000,45442940,1
104,3963,30462,150,5.3,0,23006849,12000000,11006849,1
126,23866,54042,215,7.6,0,38413606,30000000,8413606,1
93,1874,38399,218,6.9,0,50159144,36000000,14159144,1
103,2730,45890,177,7,0,42365581,5000000,37365581,1
108,649,33741,141,8.1,0,1.7e+07,3000000,1.4e+07,1
102,5443,53115,282,3.8,0,99423521,35000000,64423521,1
118,3797,21767,127,6.7,0,34742066,30000000,4742066,1
80,4394,16385,100,4.6,0,201584141,80000000,121584141,1
97,3455,74626,157,7.3,8000,28215918,3500000,24715918,1
111,14823,93894,286,7.6,0,49800000,3600000,46200000,1
93,822,74743,93,6.5,0,328203506,5000000,323203506,1
105,2129,56646,336,6.4,0,177841558,70000000,107841558,1
181,934,29839,150,8,0,10404330,9000000,1404330,1
129,3389,223127,420,7.7,38000,309208309,29000000,280208309,1
92,13597,72287,176,7,12000,107139399,60000000,47139399,1
101,6292,43358,228,5.5,0,154749918,43000000,111749918,1
136,16805,19832,98,5.9,0,70687344,18000000,52687344,1
135,1845,36636,289,7.5,0,64445708,28000000,36445708,1
112,1823,93367,497,6.4,0,85498534,48000000,37498534,1
85,1090,94108,673,6.5,0,57891803,26000000,31891803,1
93,2986,60572,144,6.3,0,117758500,65000000,52758500,1
105,2288,186982,491,6.9,0,117760134,20000000,97760134,1
138,1205,168207,684,7.4,0,212011111,150000000,62011111,1
126,2170,149966,835,7.5,0,109502303,16000000,93502303,1
87,20097,58906,186,7,0,140161792,30000000,110161792,1
110,16230,55513,188,7.2,0,96900000,27000000,69900000,1
174,1495,148172,406,8,15000,163214286,8200000,155014286,1
99,16461,33088,143,4.8,0,40105542,15000000,25105542,1
110,7921,78241,177,6.7,0,4300000,4000000,3e+05,1
98,3827,13190,114,4.5,616,14144000,10500000,3644000,1
95,2729,15427,121,5.3,449,23430766,11000000,12430766,1
137,12947,63274,170,7.6,12000,41895491,24000000,17895491,1
136,12194,75573,662,5.5,4000,75715436,68000000,7715436,1
94,4263,114610,176,7,0,121697323,20000000,101697323,1
133,16710,17025,290,5.1,295,74608570,64000000,10608570,1
121,448,76681,228,7.6,0,85582407,12899867,72682540,1
140,1109,27800,96,5.4,0,32101000,10000000,22101000,1
91,4729,17829,99,3.7,0,149281606,20000000,129281606,1
119,4043,45798,94,6.7,1000,117615211,45000000,72615211,1
85,1173,53160,121,4.9,0,237382724,112000000,125382724,1
104,3497,59068,128,6.3,0,92601050,28000000,64601050,1
115,10507,50198,202,6.8,0,20211394,20000000,211394,1
104,5190,12702,32,5.4,0,10130000,8000000,2130000,1
91,2323,82232,174,7.2,0,257850122,3500000,254350122,1
150,3218,323207,1439,6,0,836297228,150000000,686297228,1
108,11094,100890,281,8.2,0,9600000,910000,8690000,1
91,174,31952,372,5.7,0,36690067,4000000,32690067,1
114,19739,45895,157,6.5,1000,55495563,50000000,5495563,1
119,35501,52846,143,7.7,0,34670720,14000000,20670720,1
96,18178,28109,110,6,0,100076342,37000000,63076342,1
99,1790,66941,148,5.1,1000,173959438,30000000,143959438,1
101,226,27346,206,6.5,0,5179037,2000000,3179037,1
135,43388,411164,1303,7.3,0,783766341,200000000,583766341,1
93,837,73501,333,7.3,27000,13008928,4000000,9008928,1
97,1269,55982,148,7.3,17000,4270000,967686,3302314,1
91,27405,60370,264,3.4,0,149673788,79000000,70673788,1
97,9814,38298,147,6.3,782,61347797,60000000,1347797,1
141,30063,59569,89,6.5,0,195268056,45000000,150268056,1
85,1653,30651,267,3.4,1000,39267515,19000000,20267515,1
92,4730,185338,392,6.7,0,167722310,20000000,147722310,1
84,2065,142619,586,7.5,24000,3221152,60000,3161152,1
82,2898,39095,187,3.5,16000,80547866,20000000,60547866,1
113,8362,186977,529,7.6,13000,53653224,30000000,23653224,1
140,13808,57661,455,7.3,0,148336445,87000000,61336445,1
118,6427,60504,249,6.6,0,1.2e+08,38000000,8.2e+07,1
102,2910,12570,86,5.2,771,93772522,30000000,63772522,1
130,2856,55901,503,6.5,0,154937680,70000000,84937680,1
144,2523,148238,529,8,0,108539911,88000000,20539911,1
89,667,39768,292,5.3,0,50671850,25000000,25671850,1
108,35209,270238,452,7.4,19000,163670000,25000000,138670000,1
91,5349,29147,115,4.8,0,40492759,16000000,24492759,1
98,16827,49205,184,6.1,0,36160375,30000000,6160375,1
96,52138,97938,605,6.8,0,52223306,12000000,40223306,1
99,701,58349,194,6.4,0,60462347,40000000,20462347,1
139,16125,34427,126,6.9,0,31596911,28000000,3596911,1
112,106,94139,183,7.8,0,57504069,6500000,51004069,1
113,14209,17948,86,6.9,0,95404397,37000000,58404397,1
101,2013,41763,403,5.5,0,91196419,10000000,81196419,1
86,14146,53118,221,6.2,0,57223890,56000000,1223890,1
129,4264,40941,320,6.4,0,29506464,25100000,4406464,1
89,140268,57446,369,6,0,40855419,12000000,28855419,1
92,1168,57578,210,6.8,0,11806119,1500000,10306119,1
123,7072,61651,271,7.4,0,56298474,12000000,44298474,1
90,1997,110788,258,6.1,2000,202026112,100000000,102026112,1
142,16580,93494,394,6.6,0,85632458,70000000,15632458,1
84,1203,47383,132,4.8,1000,84772742,22000000,62772742,1
103,14672,27149,96,6.3,0,41382841,18000000,23382841,1
102,2235,573541,1916,8.4,38000,7390108,4500000,2890108,1
103,24333,123940,337,6.7,0,176885658,80000000,96885658,1
134,2281,25465,190,6.9,16000,67347013,40000000,27347013,1
123,5839,100001,289,5.9,0,96085477,82000000,14085477,1
163,2529,176936,824,7.6,0,130358911,70000000,60358911,1
112,5709,48621,239,6.6,0,40263020,35000000,5263020,1
122,2759,96569,522,6.7,0,144216468,19000000,125216468,1
112,5959,7973,59,5.7,0,37710610,6600000,31110610,1
107,673,80958,310,7.6,7000,60922980,2800000,58122980,1
96,1254,25086,87,4.8,1000,42,21,21,1
93,6105,42644,102,6.2,0,31155435,12000000,19155435,1
91,3244,60884,85,4.8,0,341631208,46000000,295631208,1
172,1941,40359,235,8.1,0,23650000,2100000,21550000,1
226,1862,215340,706,8.2,16000,400176459,4000000,396176459,1
123,12970,104564,587,6.5,0,96618699,40000000,56618699,1
115,10493,62037,148,6.6,0,61489265,26000000,35489265,1
138,23755,328067,533,6.7,68000,415440673,120000000,295440673,1
98,92456,82380,629,5.6,0,181674817,160000000,21674817,1
105,4813,41273,136,5.8,0,32005248,20000000,12005248,1
88,2604,59380,202,5.7,0,65535067,17000000,48535067,1
88,9913,48500,124,5.6,0,163733697,80000000,83733697,1
99,1195,91093,353,7,0,218613188,70000000,148613188,1
139,3667,98989,158,6.6,1000,309492681,80000000,229492681,1
99,3567,18727,45,6.6,0,72417394,21000000,51417394,1
90,5002,71217,228,7.2,0,27092880,4500000,22592880,1
98,2496,69733,97,6.9,0,154864401,14000000,140864401,1
116,2321,42705,274,6.3,885,149705852,60000000,89705852,1
113,2693,53741,214,8.1,0,8e+06,3200000,4800000,1
107,2440,41574,145,6.6,0,35485056,12000000,23485056,1
95,1266,37479,152,5.9,0,69631118,19000000,50631118,1
104,17109,59232,317,6.3,0,105178561,60000000,45178561,1
97,25792,17461,78,5.6,0,29010817,8000000,21010817,1
130,17771,60165,326,6.4,0,9e+07,65000000,2.5e+07,1
131,10003,135246,498,7.3,0,256271286,52000000,204271286,1
92,3950,161448,1473,6.9,0,46118097,400000,45718097,1
109,2740,109894,340,6.9,0,92374674,45000000,47374674,1
102,2754,22147,156,6.3,770,75781642,12000000,63781642,1
117,4204,14814,114,6.3,0,20529194,15000000,5529194,1
98,3151,107815,485,7.1,10000,76488889,23000000,53488889,1
93,2658,70336,269,7.3,31000,21107746,1800000,19307746,1
114,1725,48909,166,5.8,0,1106279658,22000000,1084279658,1
100,15922,29322,104,6.1,0,14400000,2000000,12400000,1
107,13904,6069,33,6.4,0,52424533,36000000,16424533,1
94,5440,26905,614,4.1,0,37664855,13000000,24664855,1
107,2151,87538,79,6,0,216614388,15000000,201614388,1
113,810,71596,276,7.1,3000,33013805,30000000,3013805,1
94,1102,79141,355,6.5,2000,56422687,25000000,31422687,1
99,960,37412,178,5.7,0,62771059,40000000,22771059,1
82,2251,23943,118,6,425,80936232,25000000,55936232,1
140,2894,79330,690,8,0,40031879,12800000,27231879,1
88,2567,28632,214,4.9,0,24829644,12000000,12829644,1
108,41359,56338,215,6.5,4000,22852638,14000000,8852638,1
85,4166,74343,98,5.3,694,294456605,71000000,223456605,1
85,29488,4006,12,5.8,0,27187375,20000000,7187375,1
154,2593,326180,899,6.3,46000,1123746996,195000000,928746996,1
107,2447,36542,378,7.4,0,29027914,13500000,15527914,1
109,4947,25344,77,5.6,0,36133014,18000000,18133014,1
103,17533,61317,229,5.2,0,94728529,35000000,59728529,1
110,2356,72886,190,6.4,35000,29657751,26000000,3657751,1
123,23920,95860,660,7.2,16000,55707411,40000000,15707411,1
92,1945,35131,255,4.8,16000,47241945,20000000,27241945,1
88,1518,23864,142,7,0,35078241,30000000,5078241,1
125,10570,78454,233,8,5000,8e+06,1800000,6200000,1
105,2505,30058,236,5.5,800,132675402,20000000,112675402,1
107,10691,9051,68,5.7,0,2.4e+07,17000000,7e+06,1
97,3679,76199,944,4.4,13000,66821036,10000000,56821036,1
106,26652,26846,193,5.6,0,35007180,15000000,20007180,1
112,2019,62584,375,6.6,0,57479076,22000000,35479076,1
109,14995,23728,213,6.1,813,28008462,21000000,7008462,1
85,6539,50415,613,2.7,806,48548426,20000000,28548426,1
133,11799,146364,237,7.4,27000,51148651,30000000,21148651,1
123,2259,20827,136,7.2,0,60251371,35000000,25251371,1
200,1966,55816,255,8,7000,111721910,14000000,97721910,1
95,2266,36363,256,3.7,1000,51376861,30000000,21376861,1
95,791,35172,128,6.1,0,92921203,4000000,88921203,1
94,15271,70341,830,4.4,0,31070211,30000000,1070211,1
94,19957,76467,236,6.8,0,18637690,3000000,15637690,1
136,1801,73006,297,7.3,0,80049764,43000000,37049764,1
141,14178,69663,133,6.9,0,215887717,62000000,153887717,1
107,2383,7973,65,6.3,0,12232628,5000000,7232628,1
87,1770,67992,327,6.6,0,64282312,5000000,59282312,1
120,33791,167750,506,6.8,10000,147298761,14500000,132798761,1
83,14261,44143,216,7,4000,122563539,80000000,42563539,1
96,4230,63951,252,7.4,0,4505922,200000,4305922,1
100,3742,11092,44,4.5,167,28818995,26000000,2818995,1
124,32871,101899,445,6.8,0,71069884,68000000,3069884,1
123,3994,52533,235,7.5,10000,41170784,21000000,20170784,1
93,46868,13506,68,4,0,15179302,5000000,10179302,1
97,2730,22243,144,4.6,686,70992898,20000000,50992898,1
97,43354,147597,395,6.9,21000,173398518,32000000,141398518,1
86,1520,47227,323,5.2,0,25562924,5000000,20562924,1
131,23325,28099,220,5.9,0,62112895,57000000,5112895,1
100,5174,16271,57,5.4,1000,73034460,35000000,38034460,1
123,30132,81026,194,7.3,0,157387195,53000000,104387195,1
170,775,15448,174,5.6,15000,67800064,22000000,45800064,1
98,7945,53126,254,6.6,0,64437847,25000000,39437847,1
83,1729,41239,166,4.6,887,22400154,22000000,400154,1
121,1051,63931,241,7.6,0,116700000,7000000,109700000,1
82,37,85423,374,6.9,12000,77516304,28000000,49516304,1
115,52571,28005,236,6.2,0,41237648,20000000,21237648,1
96,1275,60494,132,6.7,16000,39514713,28000000,11514713,1
112,1307,47876,320,6.1,0,91038276,13000000,78038276,1
75,3590,25870,281,5.1,0,27105095,9000000,18105095,1
82,3313,42761,366,5.6,2000,56870414,27000000,29870414,1
120,2054,38949,112,7.1,0,36733909,32000000,4733909,1
96,17211,189249,398,7.7,0,55112356,51500000,3612356,1
138,13184,887467,916,8.6,40000,272742922,19000000,253742922,1
99,6930,34079,97,6,0,63833449,30000000,33833449,1
84,5039,23747,207,4,0,46546197,40000000,6546197,1
93,4293,89687,666,2.3,0,86865564,20000000,66865564,1
97,4458,92924,339,7.2,19000,32222567,8500000,23722567,1
95,896,32927,161,7.6,0,7e+06,1500000,5500000,1
110,4757,185845,284,7.2,52000,19422261,15000000,4422261,1
134,1695,55350,180,5.9,0,127600435,55000000,72600435,1
170,1164,66959,258,7.9,0,7.2e+07,17000000,5.5e+07,1
91,2543,41664,205,5.9,0,30987695,17700000,13287695,1
114,10419,80338,264,5.9,0,86387857,69000000,17387857,1
131,3479,78974,141,6.2,11000,53909751,30000000,23909751,1
113,465,76616,334,7.9,0,44785053,3600000,41185053,1
87,8353,37156,129,5.3,0,11947954,3000000,8947954,1
95,2876,82819,263,6.7,0,102854431,58000000,44854431,1
90,50005,63625,64,5.2,0,177977226,80000000,97977226,1
89,1383,25960,389,4.1,1000,67192859,20000000,47192859,1
96,26826,110432,309,5.8,0,171269535,50000000,121269535,1
87,707,39690,394,6.1,0,21722776,1250000,20472776,1
77,575,13319,53,6.3,347,45554533,30000000,15554533,1
118,2704,16294,252,3.7,889,30749142,14000000,16749142,1
105,2096,47819,164,6.1,2000,103738726,47000000,56738726,1
108,1981,37714,204,7.1,0,22179430,2000000,20179430,1
129,2265,23629,141,7.3,0,18124262,8000000,10124262,1
157,1519,70233,321,8.4,0,11502151,2200000,9302151,1
93,27646,37952,298,6.5,938,16856124,8000000,8856124,1
109,4231,32370,196,6.9,0,52277485,32000000,20277485,1
88,1140,19715,166,5.9,515,13368437,6500000,6868437,1
91,116,54601,200,6.4,23000,1984662,800000,1184662,1
101,1634,15814,68,5.4,503,51702483,25000000,26702483,1
130,2662,29932,211,6.9,0,21028755,8000000,13028755,1
117,27378,48629,134,6.9,0,85300000,10000000,75300000,1
128,5404,44816,259,6.4,0,37036004,30000000,7036004,1
122,1164,17068,215,6.5,0,33456317,500000,32956317,1
190,1418,170684,867,7.6,0,207515725,48000000,159515725,1
108,936,21409,63,6.8,0,54215416,6500000,47715416,1
109,855,19230,59,6.1,0,93246388,35000000,58246388,1
95,17471,118684,447,7,24000,19152480,1987650,17164830,1
82,2400,48225,164,6.7,0,17460020,8000000,9460020,1
114,16899,54787,216,6.9,0,74237563,25000000,49237563,1
104,1235,179500,378,6,0,158468292,85000000,73468292,1
94,3153,15665,35,6.4,0,77112176,22000000,55112176,1
161,12518,52339,200,7.2,0,128499205,31000000,97499205,1
96,8097,7098,41,5,0,22456509,8500000,13956509,1
105,3535,13194,59,5.5,671,36351350,25000000,11351350,1
126,22745,47626,118,7.6,0,30226144,15000000,15226144,1
100,2186,68222,545,6.8,0,4601043,2000000,2601043,1
127,6657,26434,174,7,0,75597042,20000000,55597042,1
107,2377,53471,224,5.4,29000,15608545,15000000,608545,1
120,1779,123090,888,8,4000,35564473,4000000,31564473,1
123,5306,11600,64,6.7,7000,71625195,17000000,54625195,1
87,1592,49669,419,7.2,3000,3.4e+07,3500000,30500000,1
170,20683,32353,263,6.5,0,186883563,60000000,126883563,1
112,22479,66966,175,7.4,0,68706993,12000000,56706993,1
80,65,168398,492,8,13000,15992615,2700000,13292615,1
101,3001,43991,695,5.2,0,45479110,35000000,10479110,1
132,55345,284792,366,7.3,54000,626137675,125000000,501137675,1
98,9330,51842,173,6.3,0,41512007,31000000,10512007,1
119,6862,44838,223,6.6,0,39053061,25000000,14053061,1
110,1122,98354,433,7.7,0,1.1e+08,5000000,1.05e+08,1
87,1958,41509,300,5.6,0,67738090,1800000,65938090,1
96,4053,40514,234,6.8,808,17297244,10000000,7297244,1
92,41867,37530,106,6.2,0,10848783,8000000,2848783,1
90,34983,46813,150,6.7,12000,3542353,250000,3292353,1
131,3261,65201,651,7.3,0,87754044,19800000,67954044,1
89,2517,13913,120,4,0,36433975,7000000,29433975,1
115,688,22105,81,7.6,14000,99067206,5500000,93567206,1
101,1812,57140,195,6.2,6000,24769466,15000000,9769466,1
107,31014,40346,95,5.6,1000,60209334,50000000,10209334,1
94,16225,149549,348,6.3,0,147717833,45000000,102717833,1
127,1735,19126,155,6.7,0,6e+07,20000000,4e+07,1
98,14921,81599,250,7.4,0,39846344,6000000,33846344,1
109,1761,34471,147,5,0,1.52e+08,50000000,1.02e+08,1
112,3301,36983,100,5.9,0,36620508,20000000,16620508,1
98,2609,136048,700,7.2,0,50907422,32000000,18907422,1
112,2412,41361,148,7.3,0,62548947,3705538,58843409,1
115,14275,90677,389,6.5,0,67200000,20000000,47200000,1
114,50927,87331,364,7.5,18000,66122026,25000000,41122026,1
90,2666,38248,250,6.1,0,47175038,15000000,32175038,1
105,5740,21176,107,6.1,0,119772232,25000000,94772232,1
124,35867,204063,764,7.2,0,209196298,78000000,131196298,1
135,1920,6359,69,6.8,0,3.6e+07,5000000,3.1e+07,1
90,2807,74887,129,6.7,0,32973937,9000000,23973937,1
172,1306,76398,258,8,0,89800000,12000000,77800000,1
118,681,8856,90,7.4,0,37799643,2700000,35099643,1
104,2430,3024,22,6.1,0,1332231,134005,1198226,1
113,2681,2417,32,6,0,2861020,1200000,1661020,1
80,5628,104089,319,6.3,16000,33583175,10000000,23583175,1
114,18263,25472,109,7,0,6800000,1800000,5e+06,1
107,25296,191912,370,5.9,0,236350661,76000000,160350661,1
90,20795,85362,181,6.9,0,40485039,10000000,30485039,1
114,2668,43027,214,6.8,0,107879496,62000000,45879496,1
95,1899,36381,126,7.2,11000,9138338,1000000,8138338,1
92,1315,19699,119,4.8,387,39438674,21150000,18288674,1
117,3969,35834,284,5,0,46442528,40000000,6442528,1
99,1254,62468,374,7,0,21133087,12000000,9133087,1
103,3299,5721,20,4.9,1000,21409028,14000000,7409028,1
105,7184,68417,242,5.1,0,154906693,55000000,99906693,1
92,32875,41170,298,6.2,0,63215872,35000000,28215872,1
101,5942,27580,232,5.5,742,79958599,50000000,29958599,1
120,3280,82743,201,7.5,7000,52929168,11000000,41929168,1
91,1582,40618,144,7,0,5129058,5000000,129058,1
117,3016,34896,118,4.3,877,113309743,50000000,63309743,1
106,45327,272223,988,6.7,14000,207283925,38000000,169283925,1
93,2711,18723,146,6,0,48063435,25000000,23063435,1
110,3000,33669,269,4.6,0,37962774,37000000,962774,1
82,9271,48458,239,6.2,0,30331165,17000000,13331165,1
90,132,46158,403,5.1,0,68696770,43000000,25696770,1
107,2297,66382,612,5.1,0,110803676,50000000,60803676,1
143,20660,96654,2047,7.4,0,154648887,70000000,84648887,1
103,3143,31817,117,6.2,0,116400000,26000000,90400000,1
91,1852,9903,80,6,541,37170057,12000000,25170057,1
92,4050,49486,116,5.5,886,164433867,60000000,104433867,1
125,1651,40511,213,7.2,0,58972904,5500000,53472904,1
102,18643,120036,408,7.7,10000,7993039,6900000,1093039,1
98,13433,24438,194,6.6,0,16,8,8,1
109,6313,98794,251,5.4,0,113086475,37000000,76086475,1
107,1962,51459,113,6.5,0,80035402,8200000,71835402,1
103,2710,78343,139,6.4,0,115267375,57000000,58267375,1
93,1531,34219,578,3.3,0,61141030,12000000,49141030,1
144,2333,513158,1782,7.1,8000,709709780,150000000,559709780,1
100,4182,26413,77,4.8,372,183611771,85000000,98611771,1
83,988,30570,290,4.2,12000,101758490,1000000,100758490,1
98,235,19737,81,6,901,27645491,25000000,2645491,1
92,1652,25332,148,6.9,0,2300000,1500000,8e+05,1
97,2682,13048,227,4.1,243,38574362,14000000,24574362,1
78,11124,12845,118,6.6,624,69834815,50000000,19834815,1
92,3608,28573,72,6.5,0,3830137,3000000,830137,1
89,1752,12339,32,2.9,256,18197398,6000000,12197398,1
102,3037,26755,104,5,542,58795814,28000000,30795814,1
116,12790,74274,255,5.5,0,309457509,70000000,239457509,1
91,3310,59041,408,7,0,7412216,1500000,5912216,1
96,5282,7569,65,5.2,978,20256975,7000000,13256975,1
120,2811,15293,111,6.8,609,7900000,2000000,5900000,1
116,3110,11191,37,6.9,0,14618727,7000000,7618727,1
107,621,58871,156,6.5,0,58785180,40000000,18785180,1
94,10575,64682,203,6.3,0,22939027,12000000,10939027,1
90,56,46107,156,8,0,11125849,2000000,9125849,1
135,164,29205,194,6.3,0,141047179,55000000,86047179,1
92,1729,65551,441,5.7,0,80197993,32000000,48197993,1
98,2016,15033,75,5.9,0,20455276,17000000,3455276,1
118,2390,28649,185,5.7,2000,57588485,20000000,37588485,1
100,7252,94292,287,6.4,13000,31912793,18500000,13412793,1
110,1752,46239,155,6.8,0,7.5e+07,50000000,2.5e+07,1
98,15269,64121,241,5.9,880,103891409,73000000,30891409,1
135,3648,37911,73,6.3,1000,53854588,45000000,8854588,1
98,4879,25883,262,5.9,0,58405313,30000000,28405313,1
105,1538,8522,92,6,874,21170563,20000000,1170563,1
95,14706,18404,150,5.9,0,58900031,50000000,8900031,1
104,5265,34561,116,5.5,1000,172855065,65000000,107855065,1
128,17,29248,86,7.5,0,28814580,3766810,25047770,1
131,1344,86374,392,6.2,3000,82169884,50000000,32169884,1
102,15308,49349,165,6.9,0,38748395,25000000,13748395,1
89,4877,46492,335,6.8,7000,21378361,1000000,20378361,1
95,5245,15053,165,6.4,393,5476060,5000000,476060,1
82,2197,6808,38,6.5,227,44460850,10000000,34460850,1
117,20456,26493,159,7.3,0,23367586,12500000,10867586,1
80,11218,45984,331,7.6,0,127392239,8000000,119392239,1
106,3462,8427,88,6.4,1000,32645546,14000000,18645546,1
115,714,74351,233,1.6,62000,98441954,13000000,85441954,1
85,3617,15956,118,6,1000,1.4e+07,3500000,10500000,1
120,2892,59524,418,7.9,0,37295445,6500000,30795445,1
106,5024,35514,114,7.1,15000,47088990,18000000,29088990,1
102,1389,35065,288,6.8,0,22441323,7800000,14641323,1
118,3389,6476,71,5.7,0,30,25,5,1
100,2348,17262,53,4.5,1000,19800000,14000000,5800000,1
103,3192,36321,230,7.4,0,13350369,1000000,12350369,1
95,1421,9693,33,5.7,530,25482931,14000000,11482931,1
101,581,24959,136,8,0,4300000,1250000,3050000,1
98,684,28589,532,4.6,0,14400000,2500000,11900000,1
92,1761,34191,339,6.9,0,8279017,8000000,279017,1
110,4762,36657,318,7.5,0,2375097,1500000,875097,1
88,2622,32049,179,4.9,988,182290266,90000000,92290266,1
88,3707,29008,99,5.4,896,52970014,15000000,37970014,1
148,3967,72443,309,8,0,24475416,1000000,23475416,1
92,2240,15088,105,6.8,824,14702438,7000000,7702438,1
91,4438,22773,195,6.6,0,17985893,1000000,16985893,1
85,3712,19284,66,5.8,981,33526835,20000000,13526835,1
87,20061,11257,65,4.2,0,83761844,50000000,33761844,1
108,11459,15885,78,6.9,0,3011195,2962051,49144,1
93,1227,20815,335,4.9,0,15116634,5000000,10116634,1
94,3917,11212,94,5.2,874,38793283,26000000,12793283,1
89,2167,23408,105,4.6,810,29331068,15000000,14331068,1
107,1352,42144,213,6.1,690,77920346,60000000,17920346,1
88,1136,29629,374,5.9,0,17768757,5000000,12768757,1
129,2330,26310,154,7.8,0,53977250,16000000,37977250,1
111,26088,45602,114,6.1,979,140807547,90000000,50807547,1
115,3946,16469,275,6.9,0,36609995,24000000,12609995,1
94,1044,39798,69,5.9,0,79817939,25000000,54817939,1
96,995,13949,98,6.1,453,9482579,3500000,5982579,1
99,14306,12519,107,6.4,0,19905359,5000000,14905359,1
108,4500,129719,855,6.4,0,69623713,15000000,54623713,1
86,3854,88518,409,2.7,0,84646831,30000000,54646831,1
103,4441,37681,151,5.5,0,38368909,12000000,26368909,1
170,15,18980,74,8.3,0,7830611,700000,7130611,1
106,18630,22649,131,6.3,0,40222729,32000000,8222729,1
100,3362,44502,46,6.4,0,50752337,10000000,40752337,1
114,2484,42987,201,6.5,0,30050028,15000000,15050028,1
105,12344,98199,169,6.3,0,299288605,38000000,261288605,1
99,10469,26051,164,4.4,0,49627779,40000000,9627779,1
135,6214,21406,169,6.5,0,16929123,13000000,3929123,1
96,17913,104831,423,5.4,32000,240159255,65000000,175159255,1
105,13145,55382,129,8.3,63000,7871522,2000000,5871522,1
123,1633,66610,429,8,0,24538513,9000000,15538513,1
125,1097,6142,52,6.9,1000,29174648,9250000,19924648,1
95,3558,22679,149,4.6,773,97918663,32000000,65918663,1
97,2640,12980,132,6.9,646,18535191,14000000,4535191,1
102,2475,59474,418,7.3,0,28451622,6500000,21951622,1
104,2442,23986,201,7.1,0,31899000,6500000,25399000,1
111,1450,15582,132,6,849,46905889,15000000,31905889,1
94,3423,27580,172,5.3,0,55534455,17000000,38534455,1
101,2697,13010,182,5.9,0,6852450,6000000,852450,1
95,4837,4598,29,6.1,375,14011454,7000000,7011454,1
111,2403,107801,109,6,0,201957688,15000000,186957688,1
119,40054,361924,641,6.7,0,341131793,150000000,191131793,1
100,0,85028,404,7.3,0,28575078,65000,28510078,1
97,6388,27265,321,6.5,0,10571408,10000000,571408,1
100,3190,3924,26,5.8,368,29392418,10000000,19392418,1
87,2452,34711,468,5,0,66966987,15000000,51966987,1
103,1440,50389,136,6.3,0,53208180,31000000,22208180,1
100,4259,37885,247,6.5,0,25605015,10000000,15605015,1
110,3376,19440,56,7.3,0,38105395,11000000,27105395,1
94,2861,15115,102,6.7,0,31063038,3400000,27663038,1
94,13446,13866,55,5.5,488,13196245,11000000,2196245,1
130,3107,9566,81,6.4,1000,29381649,16000000,13381649,1
101,1954,25613,121,6.5,0,29450919,10000000,19450919,1
98,2705,10483,125,5.4,0,10429707,5000000,5429707,1
126,1363,17799,133,8,0,5e+06,1000000,4e+06,1
92,1447,11283,155,7.7,0,1678874,1000000,678874,1
102,677,16323,91,7.3,0,35323292,35000000,323292,1
106,1871,21225,268,6.4,1000,11588205,10284523,1303682,1
98,4277,12942,34,5.1,902,23144499,3000000,20144499,1
132,914,9503,68,6.6,0,30400000,12000000,18400000,1
98,24664,14888,83,4.4,747,61112916,50000000,11112916,1
129,2300,15401,175,7,10000,34522221,1000000,33522221,1
84,2737,23928,73,5.9,441,20342161,10000000,10342161,1
81,824,13269,98,7.8,1000,3202000,609000,2593000,1
94,31005,16059,210,6.1,0,27500000,13000000,14500000,1
117,3841,20183,41,5.4,0,70100000,40000000,30100000,1
107,552,15730,31,6.7,0,34793160,14000000,20793160,1
96,1866,7528,88,5.5,0,3412497,1250000,2162497,1
104,21397,452928,1401,7.4,0,157299717,75000000,82299717,1
100,6296,7322,78,7.1,680,15795189,10000000,5795189,1
124,5135,14322,116,7.2,0,27728118,20000000,7728118,1
89,995,7921,97,7.7,439,2300000,439000,1861000,1
97,5006,5928,49,4.3,243,31179516,12000000,19179516,1
96,2018,7736,100,6.4,0,7292175,7000000,292175,1
120,5420,6525,79,6.7,0,34573780,9000000,25573780,1
95,3845,6095,76,6.2,1000,2.1e+07,15000000,6e+06,1
101,11327,8662,172,4.7,134,2506446,2000000,506446,1
87,9555,18711,183,5.4,0,3076820,3000000,76820,1
97,3036,39508,96,7.5,0,27900000,3500000,24400000,1
120,5963,4100,35,6.8,352,5731103,2400000,3331103,1
91,1760,14904,147,5.7,0,17843379,8000000,9843379,1
105,179,3849,37,7.9,0,3166000,2600000,566000,1
109,5977,17770,172,6.9,0,13401952,4000000,9401952,1
101,302,19234,258,5.5,0,8025872,4700000,3325872,1
126,13591,13587,80,6.3,729,7230000,5000000,2230000,1
104,21714,383427,1912,6.8,0,234360014,210000000,24360014,1
132,50983,518537,698,7.8,54000,344420111,160000000,184420111,1
132,1936,12549,109,6.6,883,74787599,30000000,44787599,1
109,1620,8904,31,5.9,0,27515786,14000000,13515786,1
113,167,28951,257,8,0,5596708,2900000,2696708,1
129,1635,278362,552,6.5,0,229074524,73000000,156074524,1
95,2000,8707,36,2.1,244,7e+06,5800000,1200000,1
98,2095,8697,122,6.3,374,1943649,1700000,243649,1
91,1660,22408,272,7.3,0,18750246,6000000,12750246,1
102,729,3000,75,5.4,902,5.4e+07,12000000,4.2e+07,1
164,1334,12980,89,7.4,845,27187653,8000000,19187653,1
123,11969,8309,39,6,315,7.6e+07,27000000,4.9e+07,1
90,2655,26407,154,7.3,1000,603943,500000,103943,1
111,916,12399,382,6.7,0,10178331,100000,10078331,1
92,2574,219501,1236,5.9,0,368780809,93000000,275780809,1
120,3233,58137,520,5.5,67000,143093317,200000000,-56906683,0
115,27214,32567,106,6.3,0,12639297,28000000,-15360703,0
137,27666,40568,185,6.4,18000,3324330,50000000,-46675670,0
107,42683,47320,188,5.5,12000,30418560,60000000,-29581440,0
133,28129,38983,207,5.4,11000,17752940,70000000,-52247060,0
117,3524,27481,113,6.8,12000,52099090,80000000,-27900910,0
148,707,61935,242,6.7,18000,11110975,20000000,-8889025,0
102,11184,16645,72,6.9,0,1477002,2000000,-522998,0
90,16358,128455,514,8,0,23159305,70000000,-46840695,0
90,1442,31489,140,7.3,0,3759286,8000000,-4240714,0
122,28328,71782,161,7,27000,93820758,100000000,-6179242,0
133,17040,580999,2110,8.1,33000,1270522,6000000,-4729478,0
125,3979,45799,180,7,0,12007070,20000000,-7992930,0
108,4710,23775,134,5.8,73000,16374328,28000000,-11625672,0
110,12876,28618,91,6,11000,34227298,40000000,-5772702,0
108,15634,74315,259,5.9,0,40203020,50000000,-9796980,0
95,1885,30219,200,5.6,22000,187112,4000000,-3812888,0
111,23566,177401,504,7.3,32000,27635305,32000000,-4364695,0
111,21393,39956,186,5.8,24000,128388320,150000000,-21611680,0
95,578,203458,588,7.1,46000,41037742,50000000,-8962258,0
115,1686,28429,110,5.8,0,10664749,40000000,-29335251,0
112,12897,32382,99,7,13000,2450846,5000000,-2549154,0
87,3144,87451,660,3.3,0,82102379,100000000,-17897621,0
112,25269,23334,87,6.2,0,318982,16000000,-15681018,0
105,1411,99035,289,6.2,17000,50549107,60000000,-9450893,0
120,3175,68720,191,5.8,0,72178895,110000000,-37821105,0
144,427,105144,405,7.1,27000,28258060,32000000,-3741940,0
118,43105,213226,648,7.7,15000,10680275,18500000,-7819725,0
128,20965,116994,324,6.3,35000,150962475,175000000,-24037525,0
145,203,111841,413,8.3,12000,650422,92620000,-91969578,0
115,13761,110364,261,6.9,0,94882889,100000000,-5117111,0
105,1099,84508,308,5.6,20000,117831631,130000000,-12168369,0
85,35161,85086,122,6.7,0,64459316,149000000,-84540684,0
116,1899,31124,313,4.2,764,38629478,70000000,-31370522,0
116,24134,83171,231,6.8,17000,15400000,22000000,-6600000,0
119,2853,242599,1594,8,14000,38869464,39000000,-130536,0
170,34582,264318,799,7.5,0,1.02e+08,116000000,-1.4e+07,0
91,1564,23072,89,5.4,0,14431253,35000000,-20568747,0
106,1942,220591,641,7.8,17000,12532777,36000000,-23467223,0
123,13934,57038,261,6.6,0,67631903,75000000,-7368097,0
116,49608,105556,157,6.5,17000,57777106,66000000,-8222894,0
130,450,25474,138,6.9,0,42093706,50000000,-7906294,0
91,17299,71137,229,6.6,0,73661010,75000000,-1338990,0
130,15835,128729,551,7.1,50000,3029870,7400000,-4370130,0
107,11623,190132,801,7.3,15000,32017803,50000000,-17982197,0
109,16479,361767,1206,7.9,17000,69959751,76000000,-6040249,0
98,21414,8885,56,5.8,0,1397284,25000000,-23602716,0
127,2230,21098,56,6.9,0,24902723,25000000,-97277,0
122,12076,248123,437,7.6,10000,24127895,42000000,-17872105,0
104,16481,81800,211,5.5,15000,28931401,50000000,-21068599,0
99,896,92464,331,7.3,19000,1.1e+07,25000000,-1.4e+07,0
82,3266,52052,173,4.5,0,25871834,35000000,-9128166,0
157,18216,133526,521,7.9,0,60289912,90000000,-29710088,0
90,15494,52908,102,6.5,0,17869048,55000000,-37130952,0
108,14127,121432,310,6.8,10000,20645327,33000000,-12354673,0
101,993,51349,213,4.3,0,71073932,87000000,-15926068,0
112,12687,273921,522,7.5,36000,47664559,60000000,-12335441,0
101,7747,87203,221,6.7,25000,9636289,10000000,-363711,0
129,4324,72715,103,6.5,0,18755936,19000000,-244064,0
99,12166,48245,154,5.4,0,42487390,45000000,-2512610,0
119,2925,87768,187,6.3,12000,18409891,32000000,-13590109,0
135,902,57873,414,6.1,0,93945766,120000000,-26054234,0
96,31549,91640,210,5.6,20000,61648500,130000000,-68351500,0
105,2423,56402,209,6.3,17000,572809,2000000,-1427191,0
110,25049,63599,208,5.8,0,44434439,50000000,-5565561,0
106,15015,72259,788,6.4,0,85131830,137000000,-51868170,0
125,15569,60326,142,5.8,2000,48169156,50000000,-1830844,0
96,108016,115099,257,5.4,2000,1.73e+08,175000000,-2e+06,0
96,24640,190990,915,7.3,23000,15304890,35000000,-19695110,0
98,14699,80574,157,6.5,12000,23081726,24000000,-918274,0
132,55254,87785,362,6.8,0,93700000,100000000,-6300000,0
153,11852,100837,301,6.4,0,61458982,75000000,-13541018,0
103,1467,44966,411,5.6,0,25473093,30000000,-4526907,0
103,6563,48999,280,6,0,10089373,20500000,-10410627,0
117,7053,75201,256,6.6,0,74901339,80000000,-5098661,0
122,2896,21370,132,6.6,0,2429989,16000000,-13570011,0
165,921,102338,450,6.6,0,49554002,130000000,-80445998,0
99,1520,44891,202,4.2,12000,61279452,70000000,-8720548,0
121,22833,63363,644,5.6,0,49111202,50000000,-888798,0
110,1852,98629,316,7.2,0,5900000,16000000,-10100000,0
140,20152,107227,279,7.3,3000,44547681,50000000,-5452319,0
130,2525,120416,857,6.7,10000,26673242,60000000,-33326758,0
127,56585,142416,420,7.9,0,5887457,18000000,-12112543,0
131,18913,49874,450,4.6,0,20350754,45000000,-24649246,0
100,49847,55398,418,4.6,891,40002112,65000000,-24997888,0
113,391,62770,396,6,0,22211426,30000000,-7788574,0
160,22516,136104,415,7.5,0,14711793,30000000,-15288207,0
115,2990,77493,527,6.8,6000,2856712,15000000,-12143288,0
95,29926,113483,245,5.8,0,40828540,50000000,-9171460,0
97,15293,64777,201,6.4,0,6814789,12000000,-5185211,0
91,222,30842,93,5.9,0,22044277,40000000,-17955723,0
189,22186,155496,532,7.6,0,25037897,67000000,-41962103,0
111,1252,42792,162,6.7,0,5926410,15000000,-9073590,0
94,1560,99557,284,7.4,21000,20158808,27000000,-6841192,0
101,1947,31918,142,5.5,0,12206028,40000000,-27793972,0
119,2356,101834,628,5.7,0,73209340,90000000,-16790660,0
106,19610,68428,148,6.3,0,41482207,50000000,-8517793,0
111,3309,60156,299,6.8,0,16974459,20000000,-3025541,0
103,12867,109873,320,7.2,33000,9455232,15000000,-5544768,0
103,20881,53864,290,4.8,2000,39031337,60000000,-20968663,0
140,29692,332276,514,8.2,77000,23057115,25000000,-1942885,0
113,4397,45815,222,6.1,1000,21009180,45000000,-23990820,0
135,24468,101221,415,7.1,0,65900249,90000000,-24099751,0
101,53024,107859,569,6.2,0,43061982,60000000,-16938018,0
123,3254,99033,434,7.2,0,2,6000000,-5999998,0
104,16930,82731,255,6.7,0,80916492,85000000,-4083508,0
102,10552,52029,224,5.4,0,68688831,100000000,-31311169,0
172,456,55516,124,7.7,29000,8371085,12400000,-4028915,0
113,49631,83560,619,7,32000,71485043,85000000,-13514957,0
91,24669,95274,178,6.5,20000,31083599,35000000,-3916401,0
150,45757,181792,711,6.5,48000,89289910,255000000,-165710090,0
121,23602,163492,460,8,15000,12281551,12500000,-218449,0
137,33747,33107,128,6.1,27000,8784318,25000000,-16215682,0
109,2073,63548,134,6.2,0,19701164,56000000,-36298836,0
102,1815,101411,546,6.6,0,61698899,160000000,-98301101,0
106,0,59545,312,6.9,18000,6108720,9000000,-2891280,0
101,2786,106098,150,7.2,20000,6491240,8000000,-1508760,0
144,2379,63192,287,8,0,638641,6244087,-5605446,0
88,2652,17590,112,5.4,0,38992758,150000000,-111007242,0
125,1970,28635,308,5.1,893,78000586,80000000,-1999414,0
101,2471,28257,151,5.1,11000,30353232,45000000,-14646768,0
98,3357,49926,286,6.5,0,42792561,50000000,-7207439,0
105,14462,29608,92,7.2,0,1521261,6500000,-4978739,0
113,13517,88146,814,5.2,0,55987321,60000000,-4012679,0
125,10623,41727,184,6.2,0,6e+07,78146652,-18146652,0
107,13821,54650,223,6.2,12000,7563728,20000000,-12436272,0
107,25088,261317,1137,7.5,20000,5359645,20000000,-14640355,0
81,14619,45729,176,4.7,0,10539000,47000000,-36461000,0
88,2011,82331,297,6.6,18000,3964682,14350531,-10385849,0
125,15916,43651,196,6.3,997,32287044,70000000,-37712956,0
95,11994,109855,888,7.3,0,1.7e+07,25000000,-8e+06,0
105,44037,39778,172,5.4,11000,26250020,37000000,-10749980,0
177,2449,97087,569,6.6,11000,30925690,40000000,-9074310,0
116,12993,39659,189,5.6,792,65977295,70000000,-4022705,0
93,14180,162067,316,6.6,0,20796847,25000000,-4203153,0
101,3612,40964,245,6.2,0,32483410,35000000,-2516590,0
121,993,35066,196,5.3,0,48668907,120000000,-71331093,0
76,13607,13581,88,5.4,304,103951461,110000000,-6048539,0
106,17560,14281,64,6.5,0,15134293,31000000,-15865707,0
116,16484,70681,198,5.6,12000,58058367,70000000,-11941633,0
100,39507,89383,293,7.1,0,5480996,8500000,-3019004,0
99,4702,28159,96,5.1,0,12314651,14000000,-1685349,0
141,301,21223,108,7.1,13000,27330000,35000000,-7670000,0
109,20503,35990,157,5.9,0,28169671,40000000,-11830329,0
95,26940,71527,217,7.1,0,109578115,140000000,-30421885,0
125,4416,28807,273,5.9,0,50365377,58000000,-7634623,0
121,142,59462,300,6.6,0,19844979,25000000,-5155021,0
106,2,47612,348,5.7,995,33463969,80000000,-46536031,0
91,3301,34203,169,5.3,19000,36893721,40000000,-3106279,0
106,5705,15978,122,7.4,15000,6420319,20000000,-13579681,0
152,36897,207287,822,7.9,15000,47383689,60000000,-12616311,0
153,15046,55994,454,6,0,77628265,115000000,-37371735,0
99,2323,65037,273,5.9,0,15071514,80000000,-64928486,0
152,4310,45031,376,6.9,0,37317558,72000000,-34682442,0
106,12871,72868,618,6.1,0,57958696,70000000,-12041304,0
130,32637,88270,420,7.5,0,38955598,50000000,-11044402,0
165,14196,79186,386,6.8,0,87713825,107000000,-19286175,0
136,712,61995,356,5.9,33000,59418613,75000000,-15581387,0
94,23365,25681,77,6.3,0,44091067,65000000,-20908933,0
91,7875,7199,53,4.5,0,1784763,13000000,-11215237,0
111,18510,43709,141,5.3,0,67112664,70000000,-2887336,0
115,4713,23302,181,6.5,1000,56702901,70000000,-13297099,0
84,1490,108052,434,6.6,79000,495303,30000000,-29504697,0
122,24270,145422,572,7.3,0,41610884,55000000,-13389116,0
118,209,100743,549,7.4,0,47434430,82000000,-34565570,0
119,3279,21360,110,7,0,4440055,8500000,-4059945,0
94,5085,92850,263,7.1,0,21126225,29000000,-7873775,0
100,5890,44931,100,7.3,0,27409889,35000000,-7590111,0
90,1865,31640,109,4.9,791,50650079,60000000,-9349921,0
116,13180,41856,119,6.9,12000,2401510,6500000,-4098490,0
121,1520,68211,219,7.4,14000,3099314,5000000,-1900686,0
108,26050,149528,454,7.7,0,13060843,15000000,-1939157,0
101,2698,14147,92,5.6,401,17432163,20000000,-2567837,0
119,15757,139535,632,7.3,0,34808403,50000000,-15191597,0
94,2880,21542,88,6.1,977,12398628,20000000,-7601372,0
98,18085,45775,112,5.5,462,26155781,40000000,-13844219,0
110,5609,78635,1040,5.6,0,42285169,75000000,-32714831,0
91,34705,39764,148,6.7,17000,970816,21000000,-20029184,0
116,43887,53057,457,5.6,0,19480739,80000000,-60519261,0
89,74181,37493,108,5.6,0,21819348,35000000,-13180652,0
114,679,44979,298,7,0,13001257,30000000,-16998743,0
108,11519,24033,152,7,0,18618284,30000000,-11381716,0
118,27756,7663,38,6,694,46488,7000000,-6953512,0
102,1440,19686,180,5.6,689,29700000,53000000,-23300000,0
107,988,20008,112,5.7,883,1296184,5000000,-3703816,0
97,12841,74691,165,6.4,0,23580000,25000000,-1420000,0
84,8018,46239,137,6,0,38502340,50000000,-11497660,0
110,3177,7894,25,5,0,16549477,20000000,-3450523,0
131,12088,46951,175,7.1,0,43545364,65000000,-21454636,0
89,3096,46205,147,5.8,0,19322135,40000000,-20677865,0
91,648,54478,184,7.1,0,560069,7000000,-6439931,0
86,5393,9682,38,4.8,0,13521829,30000000,-16478171,0
126,20563,32815,214,7.3,0,25224242,35000000,-9775758,0
118,22447,41288,126,6.2,17000,30800231,60000000,-29199769,0
102,45202,85237,274,5.6,18000,26121638,49900000,-23778362,0
131,3012,57100,281,6.9,0,27642707,72000000,-44357293,0
102,14281,14129,39,5.1,967,2807854,11000000,-8192146,0
93,30134,28629,113,4.9,0,16863583,20000000,-3136417,0
120,33585,42547,265,6.1,748,56359980,60000000,-3640020,0
100,2085,34809,125,6.2,11000,7448385,41000000,-33551615,0
123,18793,12771,84,6.5,828,25928721,58000000,-32071279,0
87,6658,43300,250,3.8,0,41819064,62000000,-20180936,0
107,1702,15231,66,6.5,0,24719215,40000000,-15280785,0
102,13156,69172,316,6.6,0,12482775,20000000,-7517225,0
124,13073,77673,463,6,0,119269486,130000000,-10730514,0
121,286,41620,418,2.4,2000,7266209,54000000,-46733791,0
138,15149,49311,278,6.7,0,35168966,100000000,-64831034,0
113,12157,74651,313,7.9,6000,4420000,16000000,-11580000,0
93,5377,28848,76,5.7,0,10496317,35000000,-24503683,0
109,52621,45497,260,5.3,1000,19598588,75000000,-55401412,0
109,4257,32951,44,5.8,6000,17425000,20000000,-2575000,0
99,50542,31964,129,6.9,0,295750,10000000,-9704250,0
128,27614,20740,178,6.2,0,9450897,55000000,-45549103,0
129,16237,17859,89,6.6,911,10300000,38000000,-27700000,0
89,1243,30215,95,5,0,6948633,17900000,-10951367,0
193,6341,45271,170,7.9,0,21500000,27000000,-5500000,0
134,1044,81611,274,6,0,13100000,75000000,-61900000,0
102,43810,31089,261,5.4,20000,1826705,2800000,-973295,0
107,29743,69197,216,6.4,0,18552460,32000000,-13447540,0
177,4346,56403,376,6,0,17626234,80000000,-62373766,0
108,2799,22823,113,5.6,0,17280326,20000000,-2719674,0
94,838,37626,521,2.3,1000,10442808,20000000,-9557192,0
89,1335,24412,240,7.1,944,3193102,10000000,-6806898,0
63,1002,15600,55,7.3,0,14460000,30000000,-15540000,0
212,5708,35314,145,6.6,0,25052000,63000000,-37948000,0
122,27381,88590,419,7.4,0,9500000,15000000,-5500000,0
100,32288,75675,365,7.8,0,10725228,12500000,-1774772,0
131,12522,65668,342,6.5,0,55041367,80000000,-24958633,0
128,36337,29282,105,6.2,11000,8555008,28000000,-19444992,0
103,9660,5863,25,6.5,0,573335,7000000,-6426665,0
139,1068,36267,150,7.2,0,32255440,34000000,-1744560,0
117,23745,44099,143,6.7,0,31720158,60000000,-28279842,0
89,477,60522,228,7.3,0,2120439,5952000,-3831561,0
127,5702,58015,374,6,0,22944502,50000000,-27055498,0
110,18635,34356,260,6.4,705,26199517,50000000,-23800483,0
130,2888,87424,276,8.2,0,43455,1288000,-1244545,0
139,538,19114,115,6.4,0,4607608,45000000,-40392392,0
99,2748,27266,75,7,0,2899975,6000000,-3100025,0
88,4777,53342,287,6.2,16000,1104682,4000000,-2895318,0
96,17292,47800,244,6.3,0,27388767,31000000,-3611233,0
130,2452,34488,136,6.9,15000,15395087,30000000,-14604913,0
95,3092,21212,107,6.7,3000,7820688,13000000,-5179312,0
83,4024,24216,162,4.1,401,10667893,45000000,-34332107,0
118,3474,14143,102,7.1,0,1151330,13000000,-11848670,0
100,32094,60596,158,5.9,13000,27437881,30000000,-2562119,0
86,1249,37495,230,6.1,37000,672648,3000000,-2327352,0
110,25676,12233,89,6.8,0,4040588,5000000,-959412,0
97,5519,43867,83,6.3,0,6928068,19000000,-12071932,0
118,1889,24104,88,7.2,0,2849142,16000000,-13150858,0
88,2857,74945,359,1.9,0,14109284,25000000,-10890716,0
85,11301,36144,91,6.7,880,26288320,60000000,-33711680,0
124,10838,31113,212,5.7,852,32168970,42000000,-9831030,0
129,19620,52972,124,6.8,21000,2527904,30000000,-27472096,0
114,4902,60467,949,5.6,0,60874615,90000000,-29125385,0
84,6954,63216,196,6.5,0,14373825,86000000,-71626175,0
114,1005,28584,232,6.3,675,16838910,35000000,-18161090,0
121,2705,45455,388,5,0,76932943,135000000,-58067057,0
112,3547,95529,301,7.5,38000,6038942,7000000,-961058,0
125,1003,8087,33,7.1,1000,7400000,40000000,-32600000,0
115,1201,15817,210,6.7,0,17200925,18000000,-799075,0
123,12700,58658,495,6.4,0,52034889,57000000,-4965111,0
130,29,26832,247,7.7,0,9495408,18000000,-8504592,0
114,1856,20113,178,6.8,0,8801940,10000000,-1198060,0
122,50950,47203,197,6.8,0,24748670,27500000,-2751330,0
105,2327,35137,188,7.4,10000,17436509,20000000,-2563491,0
121,2251,33597,185,7,0,18432000,20000000,-1568000,0
112,16692,11983,147,6.7,365,10011050,21000000,-10988950,0
89,3372,58300,139,6.9,0,76432727,95000000,-18567273,0
114,589,27664,120,6,472,41299492,58000000,-16700508,0
110,3785,6147,36,5.4,0,346594,20000000,-19653406,0
94,15857,52244,377,6.6,0,36754634,75000000,-38245366,0
115,14889,22345,144,6.8,0,529766,8000000,-7470234,0
124,14726,44795,314,7.4,0,7060876,13500000,-6439124,0
118,14036,44453,154,5.8,0,33828318,55000000,-21171682,0
101,15935,54021,227,5.7,0,42277365,50000000,-7722635,0
121,3986,53970,435,6,0,29762011,68000000,-38237989,0
103,3639,43442,146,6.2,0,13395939,60000000,-46604061,0
122,1291,20000,188,6.2,0,6754898,12000000,-5245102,0
104,3148,35018,180,3.9,716,10696210,22000000,-11303790,0
100,15944,43376,249,5.7,0,17218080,65000000,-47781920,0
102,1890,16474,301,4.2,785,5989640,80000000,-74010360,0
112,285,5637,57,5.2,0,17472,10000000,-9982528,0
126,34774,45296,267,6.7,0,39459427,80000000,-40540573,0
121,1887,4670,27,6,0,108348,30000000,-29891652,0
113,1171,18632,354,5.3,656,23,12000000,-11999977,0
89,2006,13145,215,3.6,725,598645,10000000,-9401355,0
108,18739,14757,51,6.2,0,1083683,12500000,-11416317,0
103,2510,150020,568,8.3,0,1729345,2540800,-811455,0
90,4377,60460,104,7.7,14000,1755212,14000000,-12244788,0
122,22319,7976,61,5.3,0,3334927,10000000,-6665073,0
98,4151,62198,139,5.6,0,24159934,35000000,-10840066,0
98,1917,11031,45,6.5,739,390659,2000000,-1609341,0
121,6617,2047,29,4.6,0,4842699,5000000,-157301,0
135,15820,12037,90,5.1,943,10382407,50000000,-39617593,0
97,1576,41663,141,5.4,531,33561137,70000000,-36438863,0
106,4239,25462,200,5.8,804,23619609,30000000,-6380391,0
108,4374,26100,97,5.9,484,17807569,20000000,-2192431,0
92,1011,9513,116,7.7,0,1.2e+07,22000000,-1e+07,0
99,2949,33186,78,5.9,0,16671505,50000000,-33328495,0
105,37766,34985,135,5.4,0,9479718,22000000,-12520282,0
140,3044,68159,209,7.2,0,34416893,38000000,-3583107,0
89,13390,21283,190,5.5,361,54249294,75000000,-20750706,0
104,4294,55749,257,6.1,0,46683377,75000000,-28316623,0
102,14463,27305,284,5.1,604,19412993,63600000,-44187007,0
116,14028,31293,254,5.3,648,51142659,75000000,-23857341,0
105,14677,21079,55,5.2,818,13854000,20000000,-6146000,0
98,2214,13174,81,7.2,0,1759252,10000000,-8240748,0
98,11770,29994,86,6.9,0,3453043,8000000,-4546957,0
103,4676,22649,212,5.9,1000,14867514,15000000,-132486,0
135,5917,41685,754,7,3000,31670620,40000000,-8329380,0
99,2542,44248,373,6,0,14567883,75000000,-60432117,0
117,16937,63459,185,6.9,3000,25023434,27000000,-1976566,0
140,12634,35565,247,6.6,2000,17800000,60000000,-42200000,0
125,3142,28130,215,6.5,0,29882645,35000000,-5117355,0
91,5593,24183,160,5.7,665,68514844,80000000,-11485156,0
116,3753,25346,167,5.7,470,30199105,40000000,-9800895,0
141,1618,17373,148,6.2,767,16123851,23000000,-6876149,0
91,1846,16761,277,3.6,391,19924033,70000000,-50075967,0
93,13403,31209,106,6.1,0,50877145,60000000,-9122855,0
96,1385,19824,179,3.7,0,12764201,50000000,-37235799,0
106,20772,23579,88,5.5,0,24048000,30000000,-5952000,0
111,2603,38017,247,6.4,12000,27107960,35000000,-7892040,0
104,7723,38203,290,4,0,20844907,42000000,-21155093,0
106,21711,39260,129,6.6,0,2995811,10000000,-7004189,0
96,664,33287,201,5.9,739,19351569,22000000,-2648431,0
95,6161,20295,164,3.8,416,7103973,100000000,-92896027,0
160,26982,15697,182,6,0,9323833,45000000,-35676167,0
127,796,31414,180,4.3,0,303877,10000000,-9696123,0
105,1185,14325,90,6.7,0,1831348,18000000,-16168652,0
104,9662,24790,173,5.2,0,6600000,25000000,-18400000,0
106,34351,114762,299,7.4,19000,11293663,12000000,-706337,0
132,4796,22447,210,6.4,0,35743308,48000000,-12256692,0
99,4169,14315,101,5.3,201,16930185,29000000,-12069815,0
118,11662,44913,181,6,3000,35402320,42000000,-6597680,0
104,3162,13065,253,4.6,897,17762705,21000000,-3237295,0
90,19952,24969,258,4.7,0,29907685,38000000,-8092315,0
102,14625,29285,174,5.4,0,25303038,67000000,-41696962,0
108,14574,50197,265,7.4,0,3049135,5000000,-1950865,0
119,971,65464,1308,2.4,0,21400000,44000000,-22600000,0
91,2899,19331,317,4.3,949,15,3000000,-2999985,0
100,2056,22309,102,6.3,0,11087569,425000000,-413912431,0
116,14780,34435,346,4.5,886,54744738,94000000,-39255262,0
112,253,24921,166,7.7,0,3432342,8000000,-4567658,0
113,708,12128,61,5.6,0,17479,20000000,-19982521,0
83,730,16268,108,4.1,0,9627492,17000000,-7372508,0
92,3935,18271,150,4.4,0,14822346,16000000,-1177654,0
97,13628,26893,126,5.8,815,19870567,70000000,-50129433,0
97,21107,12049,135,6.8,1000,1548955,6500000,-4951045,0
90,408,8824,108,6.2,559,782102,5000000,-4217898,0
105,4369,15052,116,5.2,484,22034832,35000000,-12965168,0
105,1132,32224,62,5.6,617,35431113,60000000,-24568887,0
125,14536,38076,399,5.9,0,18720175,62000000,-43279825,0
128,3126,13830,61,6.1,680,24332324,40000000,-15667676,0
102,672,17740,165,7.2,0,10827816,23000000,-12172184,0
94,2248,35830,321,6,0,34234008,55000000,-20765992,0
99,2125,17365,66,5.9,630,14358033,40000000,-25641967,0
132,58528,62981,84,6.3,0,30303072,50000000,-19696928,0
95,489,9589,105,5.8,289,2025238,6000000,-3974762,0
134,4,21606,117,7,0,5684789,28000000,-22315211,0
92,3654,33745,198,6.2,0,4152230,25000000,-20847770,0
110,2972,5917,50,5.3,177,6614280,39000000,-32385720,0
107,5992,22639,217,5.5,300,7314027,17000000,-9685973,0
99,2862,8511,87,3.9,0,56825,250000,-193175,0
145,1825,45231,315,7.3,0,34566746,80000000,-45433254,0
100,582,18693,187,6.4,0,1.3e+07,25000000,-1.2e+07,0
93,2178,28606,262,5.1,0,15007991,30000000,-14992009,0
134,36859,55329,499,7.8,0,2807390,3000000,-192610,0
142,20201,25193,217,5.9,2000,31755742,35000000,-3244258,0
106,18947,29341,93,6.7,0,5483299,5500000,-16701,0
99,2535,26126,325,5,0,19294901,35000000,-15705099,0
99,28987,7909,157,4.9,261,10719357,25000000,-14280643,0
108,1460,61417,339,5.5,941,78382433,85000000,-6617567,0
102,33153,32311,104,6.2,0,8762890,15000000,-6237110,0
85,14599,7367,37,4.7,850,69497,6000000,-5930503,0
96,774,10282,78,6.6,474,622806,2000000,-1377194,0
94,2151,10883,73,4.9,448,36850101,65000000,-28149899,0
80,29,42462,312,7.8,0,1477676,8000000,-6522324,0
88,25637,11498,53,5.3,0,6405245,15000000,-8594755,0
95,2260,11148,229,4.2,437,28283637,57000000,-28716363,0
109,55,11798,124,7.1,2000,62172050,74500000,-12327950,0
111,1573,11958,39,6.4,1000,5210988,20000000,-14789012,0
74,13917,17307,186,6.5,892,8493890,40000000,-31506110,0
107,2512,5557,34,6.4,294,143451,8000000,-7856549,0
106,6558,26551,273,6,0,11203026,45000000,-33796974,0
95,2007,3624,27,6.2,313,2955039,9000000,-6044961,0
112,2820,26720,196,7.7,920,3263585,5000000,-1736415,0
124,793,42621,531,6.8,0,29400000,35000000,-5600000,0
96,11078,11768,148,5.6,492,15427192,16000000,-572808,0
97,2521,24868,216,5.8,964,69131860,90000000,-20868140,0
108,2785,37700,50,6.3,0,13620075,16500000,-2879925,0
93,776,16224,76,6.5,830,2426851,4000000,-1573149,0
119,2052,30890,106,6,718,49718611,50000000,-281389,0
93,5580,14280,171,4.7,683,5409517,75000000,-69590483,0
100,6046,39331,481,6.3,0,9898412,30000000,-20101588,0
114,22040,14786,103,6.1,638,18653615,23000000,-4346385,0
95,2216,7242,38,5.7,0,13555988,22000000,-8444012,0
120,1082,55630,200,6.7,0,18317151,35000000,-16682849,0
98,409,16234,113,6.9,0,1569918,17000000,-15430082,0
145,1282,16995,163,7.3,0,13,25,-12,0
186,14638,12053,119,6.5,0,46495,14000000,-13953505,0
76,1908,15788,80,5.6,538,19478106,35000000,-15521894,0
86,2415,12437,107,5.3,405,6413915,14000000,-7586085,0
112,1466,46396,287,7.5,0,8038061,18000000,-9961939,0
94,15183,23928,100,6.6,0,13801755,20000000,-6198245,0
88,11972,15880,93,4.9,288,6808550,50000000,-43191450,0
130,5162,16673,45,7.3,0,9793496,40000000,-30206504,0
90,6299,15517,85,3.6,500,59468275,83000000,-23531725,0
101,1215,20275,151,6.9,0,866999,4000000,-3133001,0
120,1217,22289,106,7.5,0,15431177,25000000,-9568823,0
105,1265,34592,191,6.2,0,16991902,57000000,-40008098,0
101,13811,30339,268,6.9,0,24185781,31000000,-6814219,0
124,3611,21102,169,5.6,1000,18517322,98000000,-79482678,0
109,1297,25558,221,6.1,0,17833000,30000000,-12167000,0
112,859,9408,68,6.7,608,712294,1500000,-787706,0
107,16651,43903,194,7.1,5000,13411957,25000000,-11588043,0
79,2404,12561,102,6,0,2275557,8000000,-5724443,0
94,1238,10132,130,4.7,390,36037909,40000000,-3962091,0
118,74,9740,81,6.4,389,6482195,37000000,-30517805,0
101,1860,17997,140,4.4,812,4.9e+07,50000000,-1e+06,0
106,4327,10413,111,6.3,579,28121100,38000000,-9878900,0
99,1234,5049,48,6.4,226,458232,8000000,-7541768,0
91,2700,9785,26,4.5,233,10337477,20000000,-9662523,0
94,1673,8895,48,5.7,3000,25312387,30000000,-4687613,0
86,3715,11233,32,5.4,0,11417362,14000000,-2582638,0
94,1668,12077,162,6,433,13678913,35000000,-21321087,0
96,3072,23345,167,6.1,629,19204929,30000000,-10795071,0
107,2537,16411,136,4.8,0,19829957,25000000,-5170043,0
133,48482,24145,93,7.1,0,16900000,28000000,-11100000,0
116,24618,38533,89,5.8,0,18626419,55000000,-36373581,0
91,1262,14596,282,4.8,589,14828081,90000000,-75171919,0
89,4291,14656,90,6.3,0,14782676,24000000,-9217324,0
110,1976,19176,165,5.7,956,33956608,60000000,-26043392,0
84,2915,13210,138,5.8,269,16605763,20000000,-3394237,0
95,3734,25572,123,6.2,2000,13596911,75000000,-61403089,0
124,1523,10100,59,5.4,153,8434146,24000000,-15565854,0
119,2171,22250,123,6.7,913,8888143,28000000,-19111857,0
97,3100,8687,62,2.8,0,1686429,16000000,-14313571,0
132,12133,18209,183,6.7,0,10166502,80000000,-69833498,0
120,6212,15079,79,6.1,1000,17600000,21000000,-3400000,0
95,616,8008,26,5.2,504,20080020,25530000,-5449980,0
108,3344,12993,107,4.9,476,19693891,34000000,-14306109,0
90,1335,10446,105,5.3,279,2.9e+07,75000000,-4.6e+07,0
95,2518,30682,194,6.8,0,4217115,34000000,-29782885,0
104,2795,14429,113,6.3,2000,20423389,49000000,-28576611,0
109,35561,53977,125,7.1,14000,1284399,21051437,-19767038,0
145,14735,5561,35,6.4,745,11,11,0,0
100,3855,27648,148,4.9,0,17300889,45000000,-27699111,0
118,24547,14066,75,6.1,352,17380126,38000000,-20619874,0
105,6152,7073,29,5.3,204,17193231,25000000,-7806769,0
104,2109,31788,243,6.1,0,52322400,60000000,-7677600,0
112,43560,17757,99,6.5,982,11207130,25000000,-13792870,0
212,21130,23996,161,7.1,915,13681765,44000000,-30318235,0
94,4484,11011,78,4.6,422,6230276,7000000,-769724,0
280,1671,13215,497,6.3,953,12923936,56000000,-43076064,0
99,8297,28855,190,7.2,0,2,6000000,-5999998,0
108,1023,21998,227,6.8,0,29202884,30000000,-797116,0
100,1661,5187,64,5.5,902,4884663,12000000,-7115337,0
86,2165,11693,104,5.4,613,10424470,14000000,-3575530,0
101,842,30092,129,6.1,0,12,23000000,-22999988,0
101,17665,5936,91,5.7,242,1631839,10000000,-8368161,0
108,34377,21319,166,6.2,416,22433915,40000000,-17566085,0
119,3306,23823,201,5.6,713,5001655,8500000,-3498345,0
99,2498,9361,162,4.7,378,24362772,25000000,-637228,0
104,2888,12856,291,4.7,299,27053815,40000000,-12946185,0
89,1136,5615,64,6.8,592,653621,2000000,-1346379,0
114,4334,10410,71,6.9,892,4651977,35000000,-30348023,0
122,25173,13239,97,6.5,0,2281089,16800000,-14518911,0
325,14255,9830,189,6.8,1000,3484331,44000000,-40515669,0
117,611,3334,52,4.8,739,5778353,25000000,-19221647,0
134,24351,35140,409,6.4,0,38058335,45000000,-6941665,0
101,966,8143,203,6.8,0,46,35000000,-34999954,0
101,3431,24019,199,7.1,983,27674124,30000000,-2325876,0
99,1721,16555,139,5.9,817,1.3e+07,27000000,-1.4e+07,0
123,908,5796,177,6.3,0,13391174,20000000,-6608826,0
102,14165,14962,204,5.1,704,11560806,35000000,-23439194,0
115,2606,16562,73,6.2,697,10541523,50000000,-39458477,0
107,1067,27629,149,7.4,2000,1.2e+07,18000000,-6e+06,0
112,3757,21215,116,6.4,0,38399961,45000000,-6600039,0
87,3243,14637,100,6.2,619,16290976,24000000,-7709024,0
75,7394,5600,49,6.9,643,3566637,32000000,-28433363,0
107,5461,9227,70,5.1,422,9851610,50000000,-40148390,0
105,4238,24977,229,7.5,0,6451628,10000000,-3548372,0
98,5185,12675,158,6.3,0,742898,5000000,-4257102,0
95,4681,22844,140,5.6,876,16980098,17000000,-19902,0
97,1362,10182,130,5.9,810,54207,2000000,-1945793,0
95,2618,35888,125,5.5,0,6110000,10000000,-3890000,0
83,2907,8560,205,4.3,797,7e+06,20000000,-1.3e+07,0
108,8349,11913,97,5.8,616,12379402,47000000,-34620598,0
99,382,4195,50,6.7,0,3283371,6000000,-2716629,0
103,2457,3803,41,4.9,68,2154540,45000000,-42845460,0
113,11116,3203,85,6.5,650,4720371,7000000,-2279629,0
92,28050,16611,197,4.1,413,35134820,76000000,-40865180,0
91,36,5613,102,6.7,0,124494,2000000,-1875506,0
105,1417,7412,72,5.3,0,1429299,7000000,-5570701,0
118,619,37446,232,5.8,0,53825515,80000000,-26174485,0
83,5022,15015,113,4.2,494,12506188,35000000,-22493812,0
90,12776,12519,112,5.9,853,5108820,14000000,-8891180,0
84,10982,10777,79,5.1,671,13700000,24000000,-10300000,0
119,10984,3297,42,6,798,355688,4000000,-3644312,0
86,768,3467,13,4.6,974,563706,2000000,-1436294,0
110,1966,10073,78,7.3,816,3468572,4000000,-531428,0
93,1245,7519,39,5.9,445,20380,15000000,-14979620,0
116,1209,12366,151,7,507,1980338,5000000,-3019662,0
114,1816,18366,219,6.9,0,18253415,20000000,-1746585,0
104,3133,4102,89,4.4,53,10372291,90000000,-79627709,0
108,1263,10832,102,6.7,0,6e+06,18000000,-1.2e+07,0
108,1263,10832,102,6.7,0,6e+06,18000000,-1.2e+07,0
135,1508,4885,25,7.1,262,1.5e+07,35000000,-2e+07,0
107,1592,3843,25,6.4,399,305070,20000000,-19694930,0
135,2735,6377,181,7.1,345,5164404,10000000,-4835596,0
89,88422,5332,37,4.9,431,28972508,40000000,-11027492,0
99,2478,29058,238,7,838,4777465,9000000,-4222535,0
106,1610,5673,37,6.8,0,589304,8000000,-7410696,0
139,446,2427,27,5.7,127,2474000,14000000,-11526000,0
96,5668,11439,190,5.3,901,4398989,6000000,-1601011,0
105,2684,11387,147,6.6,357,2062066,7000000,-4937934,0
108,2029,4124,29,5.9,916,453079,7000000,-6546921,0
107,4971,11709,101,5.3,650,12372410,24000000,-11627590,0
